"DATA/CZAS";"TYP";"ZLECENIE#";"TRANSAKCJA#";"ZLECENIE POWIĄZANE#";"INSTRUMENT";"JEDNOSTKI/IL.";"CENA";"TOLERANCJA CENA";"STOP LOSS";"TAKE PROFIT";"DEPOZYT ZABEZPIECZAJĄCY (PLN)";"KURS WYMIANY";"WARTOŚĆ POZYCJI (PLN)";"ZAKSIĘGOWANA KWOTA (PLN)";"SALDO (PLN)";"WARTOŚĆ WYŁĄCZAJĄC OPŁATĘ";"OPŁATA";"KOSZTY UTRZYMANIA POZYCJI - WARTOŚĆ POZYCJI";"STAWKA ZA UTRZYMANIE POZYCJI";"KOSZTY UTRZYMANIA POZYCJI (PLN)";"KOSZTY UTRZYMANIA POZYCJI - WYRÓWNANIE (PLN)";"KOSZTY UTRZYMANIA POZYCJI - SUMA (PLN)";"OPŁATA";"ZWROT %";"KIERUNEK";"WYPŁATA GDY ZYSK";"WYPŁATA GDY BEZ ZMIANY";"OTWARCIE";"WYGAŚNIĘCIE";"ROZLICZENIE";"CENA ROZLICZENIA";"WYNIK";"WYPŁATA";"TYP";"WYGAŚNIĘCIE";"CENA WYKONAWCZA";"ROZLICZENIE";"CENA ROZLICZENIA";"ZYSK";"STRATA"
"26 Sie 2020 23:00:39";"Koszty Utrzymania Pozycji";"854654399";"-";"-";"Rachunek";"-";"-";"-";"-";"-";"-";"-";"-";"-1,60";"430,56";"-";"-";"-";"-";"-";"-";"-1,60";"-";"-";"-";"-";"-";"-";"-";"-";"-";"-";"-";"-";"-";"-";"-";"-";"-";"-"
"26 Sie 2020 23:00:39";"Koszty Utrzymania Pozycji";"O4-86-42WK6N";"-";"-";"Złoto - Kasowy";"-";"-";"-";"-";"-";"-";"-";"-";"-";"-";"-";"-";"1 082,77";"-1,68305%";"-0,19";"0,00";"-0,19";"-";"-";"-";"-";"-";"-";"-";"-";"-";"-";"-";"-";"-";"-";"-";"-";"-";"-"
"26 Sie 2020 23:00:39";"Koszty Utrzymania Pozycji";"O4-83-42M7E9";"-";"-";"Złoto - Kasowy";"-";"-";"-";"-";"-";"-";"-";"-";"-";"-";"-";"-";"813,06";"-1,68305%";"-0,14";"0,00";"-0,14";"-";"-";"-";"-";"-";"-";"-";"-";"-";"-";"-";"-";"-";"-";"-";"-";"-";"-"
"26 Sie 2020 23:00:39";"Koszty Utrzymania Pozycji";"O4-86-42WKHR";"-";"-";"Złoto - Kasowy";"-";"-";"-";"-";"-";"-";"-";"-";"-";"-";"-";"-";"781,79";"-1,68305%";"-0,13";"0,00";"-0,13";"-";"-";"-";"-";"-";"-";"-";"-";"-";"-";"-";"-";"-";"-";"-";"-";"-";"-"
"26 Sie 2020 23:00:39";"Koszty Utrzymania Pozycji";"O4-83-42M25M";"-";"-";"Złoto - Kasowy";"-";"-";"-";"-";"-";"-";"-";"-";"-";"-";"-";"-";"1 354,45";"-1,68305%";"-0,23";"0,00";"-0,23";"-";"-";"-";"-";"-";"-";"-";"-";"-";"-";"-";"-";"-";"-";"-";"-";"-";"-"
"26 Sie 2020 23:00:39";"Koszty Utrzymania Pozycji";"O4-83-42M77Y";"-";"-";"Złoto - Kasowy";"-";"-";"-";"-";"-";"-";"-";"-";"-";"-";"-";"-";"813,06";"-1,68305%";"-0,14";"0,00";"-0,14";"-";"-";"-";"-";"-";"-";"-";"-";"-";"-";"-";"-";"-";"-";"-";"-";"-";"-"
"26 Sie 2020 23:00:39";"Koszty Utrzymania Pozycji";"O4-86-42WP7Y";"-";"-";"Złoto - Kasowy";"-";"-";"-";"-";"-";"-";"-";"-";"-";"-";"-";"-";"781,79";"-1,68305%";"-0,13";"0,00";"-0,13";"-";"-";"-";"-";"-";"-";"-";"-";"-";"-";"-";"-";"-";"-";"-";"-";"-";"-"
"26 Sie 2020 23:00:39";"Koszty Utrzymania Pozycji";"O4-86-42WKGE";"-";"-";"Złoto - Kasowy";"-";"-";"-";"-";"-";"-";"-";"-";"-";"-";"-";"-";"1 082,77";"-1,68305%";"-0,19";"0,00";"-0,19";"-";"-";"-";"-";"-";"-";"-";"-";"-";"-";"-";"-";"-";"-";"-";"-";"-";"-"
"26 Sie 2020 23:00:39";"Koszty Utrzymania Pozycji";"O4-86-42WP8K";"-";"-";"Złoto - Kasowy";"-";"-";"-";"-";"-";"-";"-";"-";"-";"-";"-";"-";"781,79";"-1,68305%";"-0,13";"0,00";"-0,13";"-";"-";"-";"-";"-";"-";"-";"-";"-";"-";"-";"-";"-";"-";"-";"-";"-";"-"
"26 Sie 2020 23:00:39";"Koszty Utrzymania Pozycji";"O4-86-42WK8W";"-";"-";"Złoto - Kasowy";"-";"-";"-";"-";"-";"-";"-";"-";"-";"-";"-";"-";"1 082,77";"-1,68305%";"-0,19";"0,00";"-0,19";"-";"-";"-";"-";"-";"-";"-";"-";"-";"-";"-";"-";"-";"-";"-";"-";"-";"-"
"26 Sie 2020 23:00:39";"Koszty Utrzymania Pozycji";"O4-86-42WKGV";"-";"-";"Złoto - Kasowy";"-";"-";"-";"-";"-";"-";"-";"-";"-";"-";"-";"-";"781,79";"-1,68305%";"-0,13";"0,00";"-0,13";"-";"-";"-";"-";"-";"-";"-";"-";"-";"-";"-";"-";"-";"-";"-";"-";"-";"-"
"26 Sie 2020 15:10:30";" Transakcja Kupna";"O4-86-42WP8K";"T4-86-390DLC";"-";"Złoto - Kasowy";"0,4 Jednost.";"1 915,84";"-";"1 896,66";"-";"-";"3,75337";"2 876,34";"0,00";"-";"-";"-";"-";"-";"-";"-";"-";"-";"-";"-";"-";"-";"-";"-";"-";"-";"-";"-";"-";"-";"-";"-";"-";"-";"-"
"26 Sie 2020 15:10:21";" Transakcja Kupna";"O4-86-42WP7Y";"T4-86-390DKS";"-";"Złoto - Kasowy";"0,4 Jednost.";"1 916,34";"-";"1 897,14";"-";"-";"3,75377";"2 877,39";"0,00";"-";"-";"-";"-";"-";"-";"-";"-";"-";"-";"-";"-";"-";"-";"-";"-";"-";"-";"-";"-";"-";"-";"-";"-";"-";"-"
"26 Sie 2020 14:25:10";" Transakcja Kupna";"O4-86-42WKHR";"T4-86-3908QG";"-";"Złoto - Kasowy";"0,4 Jednost.";"1 909,82";"-";"1 890,73";"-";"-";"3,75021";"2 864,89";"0,00";"-";"-";"-";"-";"-";"-";"-";"-";"-";"-";"-";"-";"-";"-";"-";"-";"-";"-";"-";"-";"-";"-";"-";"-";"-";"-"
"26 Sie 2020 14:24:54";" Transakcja Kupna";"O4-86-42WKGV";"T4-86-3908PZ";"-";"Złoto - Kasowy";"0,4 Jednost.";"1 909,81";"-";"1 890,71";"-";"-";"3,74948";"2 864,31";"0,00";"-";"-";"-";"-";"-";"-";"-";"-";"-";"-";"-";"-";"-";"-";"-";"-";"-";"-";"-";"-";"-";"-";"-";"-";"-";"-"
"26 Sie 2020 14:24:46";" Transakcja Kupna";"O4-86-42WKGE";"T4-86-3908PL";"-";"Złoto - Kasowy";"0,554 Jednost.";"1 909,66";"-";"1 890,56";"-";"-";"3,74923";"3 966,50";"0,00";"-";"-";"-";"-";"-";"-";"-";"-";"-";"-";"-";"-";"-";"-";"-";"-";"-";"-";"-";"-";"-";"-";"-";"-";"-";"-"
"26 Sie 2020 14:22:24";" Transakcja Kupna";"O4-86-42WK8W";"T4-86-3908J4";"-";"Złoto - Kasowy";"0,554 Jednost.";"1 909,98";"-";"1 890,88";"-";"-";"3,75008";"3 968,06";"0,00";"-";"-";"-";"-";"-";"-";"-";"-";"-";"-";"-";"-";"-";"-";"-";"-";"-";"-";"-";"-";"-";"-";"-";"-";"-";"-"
"26 Sie 2020 14:21:32";" Transakcja Kupna";"O4-86-42WK6N";"T4-86-3908GD";"-";"Złoto - Kasowy";"0,554 Jednost.";"1 910,31";"-";"1 891,19";"-";"-";"3,75034";"3 969,02";"0,00";"-";"-";"-";"-";"-";"-";"-";"-";"-";"-";"-";"-";"-";"-";"-";"-";"-";"-";"-";"-";"-";"-";"-";"-";"-";"-"
"26 Sie 2020 14:21:28";" Zamknięcie Transakcji";"O4-86-42WK6G";"T4-86-3908G9";"O4-83-42MC3P";"Gaz Ziemny - Kasowy";"150 Jednost.";"2,486";"-";"-";"-";"-";"3,72797";"1 398,52";"70,46";"432,16";"-";"-";"-";"-";"-";"-";"-";"-";"-";"-";"-";"-";"-";"-";"-";"-";"-";"-";"-";"-";"-";"-";"-";"-";"-"
"26 Sie 2020 14:21:28";" Zamknięcie Transakcji";"O4-86-42WK6G";"T4-86-3908G8";"O4-83-42M26H";"Gaz Ziemny - Kasowy";"150 Jednost.";"2,486";"-";"-";"-";"-";"3,72797";"1 398,52";"57,04";"361,70";"-";"-";"-";"-";"-";"-";"-";"-";"-";"-";"-";"-";"-";"-";"-";"-";"-";"-";"-";"-";"-";"-";"-";"-";"-"
"25 Sie 2020 23:00:35";"Koszty Utrzymania Pozycji";"854216134";"-";"-";"Rachunek";"-";"-";"-";"-";"-";"-";"-";"-";"-5,19";"304,66";"-";"-";"-";"-";"-";"-";"-5,19";"-";"-";"-";"-";"-";"-";"-";"-";"-";"-";"-";"-";"-";"-";"-";"-";"-";"-"
"25 Sie 2020 23:00:35";"Koszty Utrzymania Pozycji";"O4-83-42M25M";"-";"-";"Złoto - Kasowy";"-";"-";"-";"-";"-";"-";"-";"-";"-";"-";"-";"-";"1 336,26";"-1,98377%";"-0,27";"0,00";"-0,27";"-";"-";"-";"-";"-";"-";"-";"-";"-";"-";"-";"-";"-";"-";"-";"-";"-";"-"
"25 Sie 2020 23:00:35";"Koszty Utrzymania Pozycji";"O4-83-42M26H";"-";"-";"Gaz Ziemny - Kasowy";"-";"-";"-";"-";"-";"-";"-";"-";"-";"-";"-";"-";"366,45";"-61,49393%";"-2,30";"0,00";"-2,30";"-";"-";"-";"-";"-";"-";"-";"-";"-";"-";"-";"-";"-";"-";"-";"-";"-";"-"
"25 Sie 2020 23:00:35";"Koszty Utrzymania Pozycji";"O4-83-42MC3P";"-";"-";"Gaz Ziemny - Kasowy";"-";"-";"-";"-";"-";"-";"-";"-";"-";"-";"-";"-";"366,45";"-61,49393%";"-2,30";"0,00";"-2,30";"-";"-";"-";"-";"-";"-";"-";"-";"-";"-";"-";"-";"-";"-";"-";"-";"-";"-"
"25 Sie 2020 23:00:35";"Koszty Utrzymania Pozycji";"O4-83-42M77Y";"-";"-";"Złoto - Kasowy";"-";"-";"-";"-";"-";"-";"-";"-";"-";"-";"-";"-";"802,14";"-1,98377%";"-0,16";"0,00";"-0,16";"-";"-";"-";"-";"-";"-";"-";"-";"-";"-";"-";"-";"-";"-";"-";"-";"-";"-"
"25 Sie 2020 23:00:35";"Koszty Utrzymania Pozycji";"O4-83-42M7E9";"-";"-";"Złoto - Kasowy";"-";"-";"-";"-";"-";"-";"-";"-";"-";"-";"-";"-";"802,14";"-1,98377%";"-0,16";"0,00";"-0,16";"-";"-";"-";"-";"-";"-";"-";"-";"-";"-";"-";"-";"-";"-";"-";"-";"-";"-"
"25 Sie 2020 17:41:05";" Zamknięcie Transakcji";"O4-86-42TV5J";"T4-86-38YWJ9";"O4-83-42MJHF";"Germany 30 - Kasowy";"0,0176 Jednost.";"13 057,31";"-";"-";"-";"-";"4,38559";"1 013,91";"18,07";"309,85";"-";"-";"-";"-";"-";"-";"-";"-";"-";"-";"-";"-";"-";"-";"-";"-";"-";"-";"-";"-";"-";"-";"-";"-";"-"
"25 Sie 2020 17:40:55";" Zamknięcie Transakcji";"O4-86-42TV4Y";"T4-86-38YWHS";"O4-83-42M2CP";"EUR/USD";"400,00";"1,18141";"-";"-";"-";"-";"3,71228";"1 764,79";"2,87";"291,78";"-";"-";"-";"-";"-";"-";"-";"-";"-";"-";"-";"-";"-";"-";"-";"-";"-";"-";"-";"-";"-";"-";"-";"-";"-"
"25 Sie 2020 17:27:38";" Likwidacja";"O4-86-42TSS2";"T4-86-38YVB7";"O4-83-42N13N";"Germany 30 - Kasowy";"0,0176 Jednost.";"13 082,71";"-";"-";"-";"-";"4,38373";"1 015,45";"33,07";"288,91";"-";"-";"-";"-";"-";"-";"-";"-";"-";"-";"-";"-";"-";"-";"-";"-";"-";"-";"-";"-";"-";"-";"-";"-";"-"
"25 Sie 2020 17:27:38";" Likwidacja";"O4-86-42TSS1";"T4-86-38YVB6";"O4-86-42R2KD";"Złoto - Kasowy";"0,554 Jednost.";"1 915,43";"-";"-";"-";"-";"3,73111";"3 959,26";"-41,61";"255,84";"-";"-";"-";"-";"-";"-";"-";"-";"-";"-";"-";"-";"-";"-";"-";"-";"-";"-";"-";"-";"-";"-";"-";"-";"-"
"25 Sie 2020 17:27:38";" Likwidacja";"O4-86-42TSS1";"T4-86-38YVB5";"O4-86-42QV7V";"Złoto - Kasowy";"0,828 Jednost.";"1 915,43";"-";"-";"-";"-";"3,73111";"5 917,45";"-74,95";"297,45";"-";"-";"-";"-";"-";"-";"-";"-";"-";"-";"-";"-";"-";"-";"-";"-";"-";"-";"-";"-";"-";"-";"-";"-";"-"
"25 Sie 2020 17:27:38";" Likwidacja";"O4-86-42TSS1";"T4-86-38YVB4";"O4-86-42QLVN";"Złoto - Kasowy";"0,828 Jednost.";"1 915,43";"-";"-";"-";"-";"3,73111";"5 917,45";"-90,67";"372,40";"-";"-";"-";"-";"-";"-";"-";"-";"-";"-";"-";"-";"-";"-";"-";"-";"-";"-";"-";"-";"-";"-";"-";"-";"-"
"25 Sie 2020 00:51:16";"Zmodyfikowano Stop Loss";"O4-83-42M25M";"-";"O4-83-42M25N";"Złoto - Kasowy";"0,693 Jednost.";"1 937,86";"-";"1 861,02";"-";"-";"-";"-";"-";"-";"-";"-";"-";"-";"-";"-";"-";"-";"-";"-";"-";"-";"-";"-";"-";"-";"-";"-";"-";"-";"-";"-";"-";"-";"-"
"25 Sie 2020 00:51:07";"Zmodyfikowano Stop Loss";"O4-83-42M77Y";"-";"O4-83-42M77Z";"Złoto - Kasowy";"0,416 Jednost.";"1 932,72";"-";"1 869,04";"-";"-";"-";"-";"-";"-";"-";"-";"-";"-";"-";"-";"-";"-";"-";"-";"-";"-";"-";"-";"-";"-";"-";"-";"-";"-";"-";"-";"-";"-";"-"
"25 Sie 2020 00:50:59";"Zmodyfikowano Stop Loss";"O4-83-42M7E9";"-";"O4-83-42M7EB";"Złoto - Kasowy";"0,416 Jednost.";"1 931,85";"-";"1 868,17";"-";"-";"-";"-";"-";"-";"-";"-";"-";"-";"-";"-";"-";"-";"-";"-";"-";"-";"-";"-";"-";"-";"-";"-";"-";"-";"-";"-";"-";"-";"-"
"25 Sie 2020 00:50:47";"Zmodyfikowano Stop Loss";"O4-86-42QV7V";"-";"O4-86-42QV7W";"Złoto - Kasowy";"0,828 Jednost.";"1 939,69";"-";"1 875,38";"-";"-";"-";"-";"-";"-";"-";"-";"-";"-";"-";"-";"-";"-";"-";"-";"-";"-";"-";"-";"-";"-";"-";"-";"-";"-";"-";"-";"-";"-";"-"
"25 Sie 2020 00:50:36";"Zmodyfikowano Stop Loss";"O4-86-42R2KD";"-";"O4-86-42R2KE";"Złoto - Kasowy";"0,554 Jednost.";"1 935,56";"-";"1 887,74";"-";"-";"-";"-";"-";"-";"-";"-";"-";"-";"-";"-";"-";"-";"-";"-";"-";"-";"-";"-";"-";"-";"-";"-";"-";"-";"-";"-";"-";"-";"-"
"24 Sie 2020 23:00:22";"Koszty Utrzymania Pozycji";"853792014";"-";"-";"Rachunek";"-";"-";"-";"-";"-";"-";"-";"-";"-6,27";"463,07";"-";"-";"-";"-";"-";"-";"-6,27";"-";"-";"-";"-";"-";"-";"-";"-";"-";"-";"-";"-";"-";"-";"-";"-";"-";"-"
"24 Sie 2020 23:00:22";"Koszty Utrzymania Pozycji";"O4-83-42MJHF";"-";"-";"Germany 30 - Kasowy";"-";"-";"-";"-";"-";"-";"-";"-";"-";"-";"-";"-";"230,02";"-2,48200%";"-0,07";"0,00";"-0,07";"-";"-";"-";"-";"-";"-";"-";"-";"-";"-";"-";"-";"-";"-";"-";"-";"-";"-"
"24 Sie 2020 23:00:22";"Koszty Utrzymania Pozycji";"O4-83-42M2CP";"-";"-";"EUR/USD";"-";"-";"-";"-";"-";"-";"-";"-";"-";"-";"-";"-";"400,00";"0,32594%";"-0,02";"0,00";"-0,02";"-";"-";"-";"-";"-";"-";"-";"-";"-";"-";"-";"-";"-";"-";"-";"-";"-";"-"
"24 Sie 2020 23:00:22";"Koszty Utrzymania Pozycji";"O4-86-42QV7V";"-";"-";"Złoto - Kasowy";"-";"-";"-";"-";"-";"-";"-";"-";"-";"-";"-";"-";"1 597,08";"-1,98377%";"-0,32";"0,00";"-0,32";"-";"-";"-";"-";"-";"-";"-";"-";"-";"-";"-";"-";"-";"-";"-";"-";"-";"-"
"24 Sie 2020 23:00:22";"Koszty Utrzymania Pozycji";"O4-83-42MC3P";"-";"-";"Gaz Ziemny - Kasowy";"-";"-";"-";"-";"-";"-";"-";"-";"-";"-";"-";"-";"370,50";"-61,49393%";"-2,33";"0,00";"-2,33";"-";"-";"-";"-";"-";"-";"-";"-";"-";"-";"-";"-";"-";"-";"-";"-";"-";"-"
"24 Sie 2020 23:00:22";"Koszty Utrzymania Pozycji";"O4-83-42M25M";"-";"-";"Złoto - Kasowy";"-";"-";"-";"-";"-";"-";"-";"-";"-";"-";"-";"-";"1 336,68";"-1,98377%";"-0,27";"0,00";"-0,27";"-";"-";"-";"-";"-";"-";"-";"-";"-";"-";"-";"-";"-";"-";"-";"-";"-";"-"
"24 Sie 2020 23:00:22";"Koszty Utrzymania Pozycji";"O4-86-42QLVN";"-";"-";"Złoto - Kasowy";"-";"-";"-";"-";"-";"-";"-";"-";"-";"-";"-";"-";"1 597,08";"-1,98377%";"-0,32";"0,00";"-0,32";"-";"-";"-";"-";"-";"-";"-";"-";"-";"-";"-";"-";"-";"-";"-";"-";"-";"-"
"24 Sie 2020 23:00:22";"Koszty Utrzymania Pozycji";"O4-83-42M7E9";"-";"-";"Złoto - Kasowy";"-";"-";"-";"-";"-";"-";"-";"-";"-";"-";"-";"-";"802,39";"-1,98377%";"-0,16";"0,00";"-0,16";"-";"-";"-";"-";"-";"-";"-";"-";"-";"-";"-";"-";"-";"-";"-";"-";"-";"-"
"24 Sie 2020 23:00:22";"Koszty Utrzymania Pozycji";"O4-83-42M77Y";"-";"-";"Złoto - Kasowy";"-";"-";"-";"-";"-";"-";"-";"-";"-";"-";"-";"-";"802,39";"-1,98377%";"-0,16";"0,00";"-0,16";"-";"-";"-";"-";"-";"-";"-";"-";"-";"-";"-";"-";"-";"-";"-";"-";"-";"-"
"24 Sie 2020 23:00:22";"Koszty Utrzymania Pozycji";"O4-83-42M26H";"-";"-";"Gaz Ziemny - Kasowy";"-";"-";"-";"-";"-";"-";"-";"-";"-";"-";"-";"-";"370,50";"-61,49393%";"-2,33";"0,00";"-2,33";"-";"-";"-";"-";"-";"-";"-";"-";"-";"-";"-";"-";"-";"-";"-";"-";"-";"-"
"24 Sie 2020 23:00:22";"Koszty Utrzymania Pozycji";"O4-83-42N13N";"-";"-";"Germany 30 - Kasowy";"-";"-";"-";"-";"-";"-";"-";"-";"-";"-";"-";"-";"230,02";"-2,48200%";"-0,07";"0,00";"-0,07";"-";"-";"-";"-";"-";"-";"-";"-";"-";"-";"-";"-";"-";"-";"-";"-";"-";"-"
"24 Sie 2020 23:00:22";"Koszty Utrzymania Pozycji";"O4-86-42R2KD";"-";"-";"Złoto - Kasowy";"-";"-";"-";"-";"-";"-";"-";"-";"-";"-";"-";"-";"1 068,58";"-1,98377%";"-0,22";"0,00";"-0,22";"-";"-";"-";"-";"-";"-";"-";"-";"-";"-";"-";"-";"-";"-";"-";"-";"-";"-"
"24 Sie 2020 21:12:00";"Zmodyfikowano Stop Loss";"O4-86-42QLVN";"-";"O4-86-42QLVP";"Złoto - Kasowy";"0,828 Jednost.";"1 944,78";"-";"1 883,37";"-";"-";"-";"-";"-";"-";"-";"-";"-";"-";"-";"-";"-";"-";"-";"-";"-";"-";"-";"-";"-";"-";"-";"-";"-";"-";"-";"-";"-";"-";"-"
"24 Sie 2020 21:11:49";"Zmodyfikowano Stop Loss";"O4-86-42QV7V";"-";"O4-86-42QV7W";"Złoto - Kasowy";"0,828 Jednost.";"1 939,69";"-";"1 907,69";"-";"-";"-";"-";"-";"-";"-";"-";"-";"-";"-";"-";"-";"-";"-";"-";"-";"-";"-";"-";"-";"-";"-";"-";"-";"-";"-";"-";"-";"-";"-"
"24 Sie 2020 16:44:20";"Zmodyfikowano Stop Loss";"O4-86-42QV7V";"-";"O4-86-42QV7W";"Złoto - Kasowy";"0,828 Jednost.";"1 939,69";"-";"1 915,33";"-";"-";"-";"-";"-";"-";"-";"-";"-";"-";"-";"-";"-";"-";"-";"-";"-";"-";"-";"-";"-";"-";"-";"-";"-";"-";"-";"-";"-";"-";"-"
"24 Sie 2020 16:44:13";"Zmodyfikowano Stop Loss";"O4-86-42QLVN";"-";"O4-86-42QLVP";"Złoto - Kasowy";"0,828 Jednost.";"1 944,78";"-";"1 915,16";"-";"-";"-";"-";"-";"-";"-";"-";"-";"-";"-";"-";"-";"-";"-";"-";"-";"-";"-";"-";"-";"-";"-";"-";"-";"-";"-";"-";"-";"-";"-"
"24 Sie 2020 16:43:28";" Transakcja Kupna";"O4-86-42R2KD";"T4-86-38WKD9";"-";"Złoto - Kasowy";"0,554 Jednost.";"1 935,56";"-";"1 916,17";"-";"-";"3,72548";"3 994,83";"0,00";"-";"-";"-";"-";"-";"-";"-";"-";"-";"-";"-";"-";"-";"-";"-";"-";"-";"-";"-";"-";"-";"-";"-";"-";"-";"-"
"24 Sie 2020 16:43:21";"Odrzucono Zlecenie: brak wystarczających środków";"O4-86-42R2JV";"-";"-";"Złoto - Kasowy";"0,828 Jednost.";"-";"-";"-";"-";"-";"-";"-";"-";"-";"-";"-";"-";"-";"-";"-";"-";"-";"-";"-";"-";"-";"-";"-";"-";"-";"-";"-";"-";"-";"-";"-";"-";"-";"-"
"24 Sie 2020 15:59:13";" Transakcja Kupna";"O4-86-42QV7V";"T4-86-38WD09";"-";"Złoto - Kasowy";"0,828 Jednost.";"1 939,69";"-";"1 920,24";"-";"-";"3,725";"5 982,58";"0,00";"-";"-";"-";"-";"-";"-";"-";"-";"-";"-";"-";"-";"-";"-";"-";"-";"-";"-";"-";"-";"-";"-";"-";"-";"-";"-"
"24 Sie 2020 15:12:57";" Transakcja Kupna";"O4-86-42QLVN";"T4-86-38W5JK";"-";"Złoto - Kasowy";"0,828 Jednost.";"1 944,78";"-";"1 925,32";"-";"-";"3,72218";"5 993,74";"0,00";"-";"-";"-";"-";"-";"-";"-";"-";"-";"-";"-";"-";"-";"-";"-";"-";"-";"-";"-";"-";"-";"-";"-";"-";"-";"-"
"24 Sie 2020 15:11:57";"Stop Loss";"O4-86-42QJMN";"T4-86-38W5GX";"-";"Złoto - Kasowy";"0,4 Jednost.";"1 943,55";"-";"-";"-";"-";"3,723";"2 894,33";"-4,99";"469,34";"-";"-";"-";"-";"-";"-";"-";"-";"-";"-";"-";"-";"-";"-";"-";"-";"-";"-";"-";"-";"-";"-";"-";"-";"-"
"24 Sie 2020 14:42:02";"Zmodyfikowano Stop Loss";"O4-86-42QJMN";"-";"O4-86-42QJMP";"Złoto - Kasowy";"0,4 Jednost.";"1 946,9";"-";"1 943,55";"-";"-";"-";"-";"-";"-";"-";"-";"-";"-";"-";"-";"-";"-";"-";"-";"-";"-";"-";"-";"-";"-";"-";"-";"-";"-";"-";"-";"-";"-";"-"
"24 Sie 2020 14:41:54";" Zamknięcie Transakcji";"O4-86-42QJR9";"T4-86-38W3Z9";"O4-86-42QJHS";"Złoto - Kasowy";"0,4 Jednost.";"1 948,08";"-";"-";"-";"-";"3,70555";"2 904,86";"0,00";"474,33";"-";"-";"-";"-";"-";"-";"-";"-";"-";"-";"-";"-";"-";"-";"-";"-";"-";"-";"-";"-";"-";"-";"-";"-";"-"
"24 Sie 2020 14:40:26";" Transakcja Kupna";"O4-86-42QJMN";"T4-86-38W3WC";"-";"Złoto - Kasowy";"0,4 Jednost.";"1 946,9";"-";"1 927,37";"-";"-";"3,72913";"2 904,09";"0,00";"-";"-";"-";"-";"-";"-";"-";"-";"-";"-";"-";"-";"-";"-";"-";"-";"-";"-";"-";"-";"-";"-";"-";"-";"-";"-"
"24 Sie 2020 14:39:12";" Transakcja Kupna";"O4-86-42QJHS";"T4-86-38W3SG";"-";"Złoto - Kasowy";"0,4 Jednost.";"1 948,08";"-";"1 928,55";"-";"-";"3,72952";"2 906,16";"0,00";"-";"-";"-";"-";"-";"-";"-";"-";"-";"-";"-";"-";"-";"-";"-";"-";"-";"-";"-";"-";"-";"-";"-";"-";"-";"-"
"24 Sie 2020 10:52:34";"Odrzucono Zlecenie: brak wystarczających środków";"O4-86-42Q2BL";"-";"-";"Cukier Biały - Kasowy";"2 Jednost.";"-";"-";"-";"-";"-";"-";"-";"-";"-";"-";"-";"-";"-";"-";"-";"-";"-";"-";"-";"-";"-";"-";"-";"-";"-";"-";"-";"-";"-";"-";"-";"-";"-";"-"
"21 Sie 2020 23:00:32";"Koszty Utrzymania Pozycji";"853375694";"-";"-";"Rachunek";"-";"-";"-";"-";"-";"-";"-";"-";"-15,96";"474,33";"-";"-";"-";"-";"-";"-";"-15,96";"-";"-";"-";"-";"-";"-";"-";"-";"-";"-";"-";"-";"-";"-";"-";"-";"-";"-"
"21 Sie 2020 23:00:32";"Koszty Utrzymania Pozycji";"O4-83-42MC3P";"-";"-";"Gaz Ziemny - Kasowy";"-";"-";"-";"-";"-";"-";"-";"-";"-";"-";"-";"-";"361,50";"-61,49393%";"-6,86";"0,00";"-6,86";"-";"-";"-";"-";"-";"-";"-";"-";"-";"-";"-";"-";"-";"-";"-";"-";"-";"-"
"21 Sie 2020 23:00:32";"Koszty Utrzymania Pozycji";"O4-83-42M77Y";"-";"-";"Złoto - Kasowy";"-";"-";"-";"-";"-";"-";"-";"-";"-";"-";"-";"-";"806,37";"-1,98377%";"-0,49";"0,00";"-0,49";"-";"-";"-";"-";"-";"-";"-";"-";"-";"-";"-";"-";"-";"-";"-";"-";"-";"-"
"21 Sie 2020 23:00:32";"Koszty Utrzymania Pozycji";"O4-83-42N13N";"-";"-";"Germany 30 - Kasowy";"-";"-";"-";"-";"-";"-";"-";"-";"-";"-";"-";"-";"225,20";"-2,48299%";"-0,20";"0,00";"-0,20";"-";"-";"-";"-";"-";"-";"-";"-";"-";"-";"-";"-";"-";"-";"-";"-";"-";"-"
"21 Sie 2020 23:00:32";"Koszty Utrzymania Pozycji";"O4-83-42M7E9";"-";"-";"Złoto - Kasowy";"-";"-";"-";"-";"-";"-";"-";"-";"-";"-";"-";"-";"806,37";"-1,98377%";"-0,49";"0,00";"-0,49";"-";"-";"-";"-";"-";"-";"-";"-";"-";"-";"-";"-";"-";"-";"-";"-";"-";"-"
"21 Sie 2020 23:00:32";"Koszty Utrzymania Pozycji";"O4-83-42MJHF";"-";"-";"Germany 30 - Kasowy";"-";"-";"-";"-";"-";"-";"-";"-";"-";"-";"-";"-";"225,20";"-2,48299%";"-0,20";"0,00";"-0,20";"-";"-";"-";"-";"-";"-";"-";"-";"-";"-";"-";"-";"-";"-";"-";"-";"-";"-"
"21 Sie 2020 23:00:32";"Koszty Utrzymania Pozycji";"O4-83-42M2CP";"-";"-";"EUR/USD";"-";"-";"-";"-";"-";"-";"-";"-";"-";"-";"-";"-";"400,00";"0,29929%";"-0,04";"0,00";"-0,04";"-";"-";"-";"-";"-";"-";"-";"-";"-";"-";"-";"-";"-";"-";"-";"-";"-";"-"
"21 Sie 2020 23:00:32";"Koszty Utrzymania Pozycji";"O4-83-42M26H";"-";"-";"Gaz Ziemny - Kasowy";"-";"-";"-";"-";"-";"-";"-";"-";"-";"-";"-";"-";"361,50";"-61,49393%";"-6,86";"0,00";"-6,86";"-";"-";"-";"-";"-";"-";"-";"-";"-";"-";"-";"-";"-";"-";"-";"-";"-";"-"
"21 Sie 2020 23:00:32";"Koszty Utrzymania Pozycji";"O4-83-42M25M";"-";"-";"Złoto - Kasowy";"-";"-";"-";"-";"-";"-";"-";"-";"-";"-";"-";"-";"1 343,31";"-1,98377%";"-0,82";"0,00";"-0,82";"-";"-";"-";"-";"-";"-";"-";"-";"-";"-";"-";"-";"-";"-";"-";"-";"-";"-"
"21 Sie 2020 15:11:51";"Zmodyfikowano Stop Loss";"O4-83-42MC3P";"-";"O4-83-42MC3Q";"Gaz Ziemny - Kasowy";"150 Jednost.";"2,36";"-";"2,206";"-";"-";"-";"-";"-";"-";"-";"-";"-";"-";"-";"-";"-";"-";"-";"-";"-";"-";"-";"-";"-";"-";"-";"-";"-";"-";"-";"-";"-";"-";"-"
"21 Sie 2020 15:00:45";" Transakcja Kupna";"O4-83-42N13N";"T4-83-38T3MG";"-";"Germany 30 - Kasowy";"0,0176 Jednost.";"12 654,14";"-";"12 527,59";"-";"-";"4,42133";"984,68";"0,00";"-";"-";"-";"-";"-";"-";"-";"-";"-";"-";"-";"-";"-";"-";"-";"-";"-";"-";"-";"-";"-";"-";"-";"-";"-";"-"
"21 Sie 2020 14:20:48";"Zmodyfikowano Stop Loss";"O4-83-42MJHF";"-";"O4-83-42MJHG";"Germany 30 - Kasowy";"0,0176 Jednost.";"12 823,25";"-";"12 449,19";"-";"-";"-";"-";"-";"-";"-";"-";"-";"-";"-";"-";"-";"-";"-";"-";"-";"-";"-";"-";"-";"-";"-";"-";"-";"-";"-";"-";"-";"-";"-"
"21 Sie 2020 14:03:17";"Zmodyfikowano Stop Loss";"O4-83-42MJHF";"-";"O4-83-42MJHG";"Germany 30 - Kasowy";"0,0176 Jednost.";"12 823,25";"-";"12 635,84";"-";"-";"-";"-";"-";"-";"-";"-";"-";"-";"-";"-";"-";"-";"-";"-";"-";"-";"-";"-";"-";"-";"-";"-";"-";"-";"-";"-";"-";"-";"-"
"21 Sie 2020 14:01:21";"Stop Loss";"O4-83-42M29C";"T4-83-38SWL6";"-";"Germany 30 - Kasowy";"0,0176 Jednost.";"12 722,84";"-";"-";"-";"-";"4,41073";"987,65";"-9,98";"490,29";"-";"-";"-";"-";"-";"-";"-";"-";"-";"-";"-";"-";"-";"-";"-";"-";"-";"-";"-";"-";"-";"-";"-";"-";"-"
"21 Sie 2020 13:57:29";"Zmodyfikowano Stop Loss";"O4-83-42M7E9";"-";"O4-83-42M7EB";"Złoto - Kasowy";"0,416 Jednost.";"1 931,85";"-";"1 899,44";"-";"-";"-";"-";"-";"-";"-";"-";"-";"-";"-";"-";"-";"-";"-";"-";"-";"-";"-";"-";"-";"-";"-";"-";"-";"-";"-";"-";"-";"-";"-"
"21 Sie 2020 13:57:24";"Zmodyfikowano Stop Loss";"O4-83-42M77Y";"-";"O4-83-42M77Z";"Złoto - Kasowy";"0,416 Jednost.";"1 932,72";"-";"1 899,28";"-";"-";"-";"-";"-";"-";"-";"-";"-";"-";"-";"-";"-";"-";"-";"-";"-";"-";"-";"-";"-";"-";"-";"-";"-";"-";"-";"-";"-";"-";"-"
"21 Sie 2020 13:40:11";"Zmodyfikowano Stop Loss";"O4-83-42M25M";"-";"O4-83-42M25N";"Złoto - Kasowy";"0,693 Jednost.";"1 937,86";"-";"1 899,67";"-";"-";"-";"-";"-";"-";"-";"-";"-";"-";"-";"-";"-";"-";"-";"-";"-";"-";"-";"-";"-";"-";"-";"-";"-";"-";"-";"-";"-";"-";"-"
"21 Sie 2020 13:14:30";"Odrzucono Zlecenie: brak wystarczających środków";"O4-83-42MLMS";"-";"-";"Gaz Ziemny - Kasowy";"150 Jednost.";"-";"-";"-";"-";"-";"-";"-";"-";"-";"-";"-";"-";"-";"-";"-";"-";"-";"-";"-";"-";"-";"-";"-";"-";"-";"-";"-";"-";"-";"-";"-";"-";"-";"-"
"21 Sie 2020 12:49:20";" Transakcja Kupna";"O4-83-42MJHF";"T4-83-38SNQB";"-";"Germany 30 - Kasowy";"0,0176 Jednost.";"12 823,25";"-";"12 695,11";"-";"-";"4,4078";"994,79";"0,00";"-";"-";"-";"-";"-";"-";"-";"-";"-";"-";"-";"-";"-";"-";"-";"-";"-";"-";"-";"-";"-";"-";"-";"-";"-";"-"
"21 Sie 2020 11:13:31";"Zmodyfikowano Stop Loss";"O4-83-42MC3P";"-";"O4-83-42MC3Q";"Gaz Ziemny - Kasowy";"150 Jednost.";"2,36";"-";"2,250";"-";"-";"-";"-";"-";"-";"-";"-";"-";"-";"-";"-";"-";"-";"-";"-";"-";"-";"-";"-";"-";"-";"-";"-";"-";"-";"-";"-";"-";"-";"-"
"21 Sie 2020 11:13:25";"Zmodyfikowano Stop Loss";"O4-83-42MC3P";"-";"O4-83-42MC3Q";"Gaz Ziemny - Kasowy";"150 Jednost.";"2,36";"-";"2,315";"-";"-";"-";"-";"-";"-";"-";"-";"-";"-";"-";"-";"-";"-";"-";"-";"-";"-";"-";"-";"-";"-";"-";"-";"-";"-";"-";"-";"-";"-";"-"
"21 Sie 2020 11:13:20";" Transakcja Kupna";"O4-83-42MC3P";"T4-83-38SHCQ";"-";"Gaz Ziemny - Kasowy";"150 Jednost.";"2,36";"-";"2,336";"-";"-";"3,72685";"1 319,30";"0,00";"-";"-";"-";"-";"-";"-";"-";"-";"-";"-";"-";"-";"-";"-";"-";"-";"-";"-";"-";"-";"-";"-";"-";"-";"-";"-"
"21 Sie 2020 10:28:23";" Transakcja Kupna";"O4-83-42M7E9";"T4-83-38SEGH";"-";"Złoto - Kasowy";"0,416 Jednost.";"1 931,85";"-";"1 912,51";"-";"-";"3,7277";"2 995,76";"0,00";"-";"-";"-";"-";"-";"-";"-";"-";"-";"-";"-";"-";"-";"-";"-";"-";"-";"-";"-";"-";"-";"-";"-";"-";"-";"-"
"21 Sie 2020 10:27:02";" Transakcja Kupna";"O4-83-42M77Y";"T4-83-38SEC8";"-";"Złoto - Kasowy";"0,416 Jednost.";"1 932,72";"-";"1 913,37";"-";"-";"3,72755";"2 996,99";"0,00";"-";"-";"-";"-";"-";"-";"-";"-";"-";"-";"-";"-";"-";"-";"-";"-";"-";"-";"-";"-";"-";"-";"-";"-";"-";"-"
"21 Sie 2020 09:36:01";"Transakcja Sprzedaży";"O4-83-42M2CP";"T4-83-38S9N2";"-";"EUR/USD";"400,00";"1,18334";"-";"1,19520";"-";"-";"4,39829";"1 759,31";"0,00";"-";"-";"-";"-";"-";"-";"-";"-";"-";"-";"-";"-";"-";"-";"-";"-";"-";"-";"-";"-";"-";"-";"-";"-";"-";"-"
"21 Sie 2020 09:35:24";" Transakcja Kupna";"O4-83-42M29C";"T4-83-38S9LR";"-";"Germany 30 - Kasowy";"0,0176 Jednost.";"12 851,36";"-";"12 722,84";"-";"-";"4,3965";"994,41";"0,00";"-";"-";"-";"-";"-";"-";"-";"-";"-";"-";"-";"-";"-";"-";"-";"-";"-";"-";"-";"-";"-";"-";"-";"-";"-";"-"
"21 Sie 2020 09:34:57";" Transakcja Kupna";"O4-83-42M26H";"T4-83-38S9DB";"-";"Gaz Ziemny - Kasowy";"150 Jednost.";"2,384";"-";"2,206";"-";"-";"3,71401";"1 328,12";"0,00";"-";"-";"-";"-";"-";"-";"-";"-";"-";"-";"-";"-";"-";"-";"-";"-";"-";"-";"-";"-";"-";"-";"-";"-";"-";"-"
"21 Sie 2020 09:34:49";" Transakcja Kupna";"O4-83-42M25M";"T4-83-38S9CM";"-";"Złoto - Kasowy";"0,693 Jednost.";"1 937,86";"-";"1 918,48";"-";"-";"3,71411";"4 987,81";"0,00";"-";"-";"-";"-";"-";"-";"-";"-";"-";"-";"-";"-";"-";"-";"-";"-";"-";"-";"-";"-";"-";"-";"-";"-";"-";"-"
"20 Sie 2020 21:38:43";"Aktywowano";"-";"-";"-";"Akcje amerykańskie ";"-";"-";"-";"-";"-";"-";"-";"-";"-";"-";"-";"-";"-";"-";"-";"-";"-";"-";"-";"-";"-";"-";"-";"-";"-";"-";"-";"-";"-";"-";"-";"-";"-";"-";"-"
"20 Sie 2020 17:39:14";" Zamknięcie Transakcji";"O4-83-42H3MD";"T4-83-38R7QS";"O4-83-42FLT5";"Germany 30 - Kasowy";"0,0176 Jednost.";"12 850,49";"-";"-";"-";"-";"4,3712";"994,57";"1,90";"500,27";"-";"-";"-";"-";"-";"-";"-";"-";"-";"-";"-";"-";"-";"-";"-";"-";"-";"-";"-";"-";"-";"-";"-";"-";"-"
"20 Sie 2020 17:39:14";" Zamknięcie Transakcji";"O4-83-42H3MD";"T4-83-38R7QR";"O4-83-42FL07";"Germany 30 - Kasowy";"0,0177 Jednost.";"12 850,49";"-";"-";"-";"-";"4,3975";"1 000,22";"-0,44";"498,37";"-";"-";"-";"-";"-";"-";"-";"-";"-";"-";"-";"-";"-";"-";"-";"-";"-";"-";"-";"-";"-";"-";"-";"-";"-"
"20 Sie 2020 17:39:14";" Zamknięcie Transakcji";"O4-83-42H3MD";"T4-83-38R7QQ";"O4-83-42FK0D";"Germany 30 - Kasowy";"0,0177 Jednost.";"12 850,49";"-";"-";"-";"-";"4,3975";"1 000,22";"-1,80";"498,81";"-";"-";"-";"-";"-";"-";"-";"-";"-";"-";"-";"-";"-";"-";"-";"-";"-";"-";"-";"-";"-";"-";"-";"-";"-"
"20 Sie 2020 17:39:10";" Zamknięcie Transakcji";"O4-83-42H3M2";"T4-83-38R7QK";"O4-83-42FK3P";"Gaz Ziemny - Kasowy";"150 Jednost.";"2,376";"-";"-";"-";"-";"3,70827";"1 321,62";"-21,14";"500,61";"-";"-";"-";"-";"-";"-";"-";"-";"-";"-";"-";"-";"-";"-";"-";"-";"-";"-";"-";"-";"-";"-";"-";"-";"-"
"20 Sie 2020 17:39:05";" Zamknięcie Transakcji";"O4-83-42H3LP";"T4-83-38R7QB";"O4-83-42FK6L";"EUR/USD";"400,00";"1,18578";"-";"-";"-";"-";"3,70827";"1 759,03";"-0,99";"521,75";"-";"-";"-";"-";"-";"-";"-";"-";"-";"-";"-";"-";"-";"-";"-";"-";"-";"-";"-";"-";"-";"-";"-";"-";"-"
"20 Sie 2020 17:38:59";" Zamknięcie Transakcji";"O4-83-42H3LF";"T4-83-38R7Q5";"O4-83-42GW51";"Złoto - Kasowy";"0,693 Jednost.";"1 950,97";"-";"-";"-";"-";"3,68616";"5 013,75";"28,56";"522,74";"-";"-";"-";"-";"-";"-";"-";"-";"-";"-";"-";"-";"-";"-";"-";"-";"-";"-";"-";"-";"-";"-";"-";"-";"-"
"20 Sie 2020 17:38:59";" Zamknięcie Transakcji";"O4-83-42H3LF";"T4-83-38R7Q4";"O4-83-42GTFR";"Złoto - Kasowy";"2,08 Jednost.";"1 950,97";"-";"-";"-";"-";"3,68616";"15 048,50";"117,31";"494,18";"-";"-";"-";"-";"-";"-";"-";"-";"-";"-";"-";"-";"-";"-";"-";"-";"-";"-";"-";"-";"-";"-";"-";"-";"-"
"20 Sie 2020 16:24:55";"Odrzucono Zlecenie: brak wystarczających środków";"O4-83-42GW70";"-";"-";"Złoto - Kasowy";"0,4 Jednost.";"-";"-";"-";"-";"-";"-";"-";"-";"-";"-";"-";"-";"-";"-";"-";"-";"-";"-";"-";"-";"-";"-";"-";"-";"-";"-";"-";"-";"-";"-";"-";"-";"-";"-"
"20 Sie 2020 16:24:49";"Odrzucono Zlecenie: brak wystarczających środków";"O4-83-42GW6H";"-";"-";"Złoto - Kasowy";"0,4 Jednost.";"-";"-";"-";"-";"-";"-";"-";"-";"-";"-";"-";"-";"-";"-";"-";"-";"-";"-";"-";"-";"-";"-";"-";"-";"-";"-";"-";"-";"-";"-";"-";"-";"-";"-"
"20 Sie 2020 16:24:18";" Transakcja Kupna";"O4-83-42GW51";"T4-83-38R1DM";"-";"Złoto - Kasowy";"0,693 Jednost.";"1 939,79";"-";"1 920,31";"-";"-";"3,71865";"4 998,88";"0,00";"-";"-";"-";"-";"-";"-";"-";"-";"-";"-";"-";"-";"-";"-";"-";"-";"-";"-";"-";"-";"-";"-";"-";"-";"-";"-"
"20 Sie 2020 16:24:06";"Odrzucono Zlecenie: brak wystarczających środków";"O4-83-42GW4F";"-";"-";"Złoto - Kasowy";"0,97 Jednost.";"-";"-";"-";"-";"-";"-";"-";"-";"-";"-";"-";"-";"-";"-";"-";"-";"-";"-";"-";"-";"-";"-";"-";"-";"-";"-";"-";"-";"-";"-";"-";"-";"-";"-"
"20 Sie 2020 16:23:55";"Odrzucono Zlecenie: brak wystarczających środków";"O4-83-42GW3W";"-";"-";"Złoto - Kasowy";"2,08 Jednost.";"-";"-";"-";"-";"-";"-";"-";"-";"-";"-";"-";"-";"-";"-";"-";"-";"-";"-";"-";"-";"-";"-";"-";"-";"-";"-";"-";"-";"-";"-";"-";"-";"-";"-"
"20 Sie 2020 16:20:34";"Odrzucono Zlecenie: brak wystarczających środków";"O4-83-42GVM4";"-";"-";"Złoto - Kasowy";"2,08 Jednost.";"-";"-";"-";"-";"-";"-";"-";"-";"-";"-";"-";"-";"-";"-";"-";"-";"-";"-";"-";"-";"-";"-";"-";"-";"-";"-";"-";"-";"-";"-";"-";"-";"-";"-"
"20 Sie 2020 16:11:19";" Transakcja Kupna";"O4-83-42GTFR";"T4-83-38QZX0";"-";"Złoto - Kasowy";"2,08 Jednost.";"1 935,67";"-";"1 916,38";"-";"-";"3,71817";"14 970,07";"0,00";"-";"-";"-";"-";"-";"-";"-";"-";"-";"-";"-";"-";"-";"-";"-";"-";"-";"-";"-";"-";"-";"-";"-";"-";"-";"-"
"20 Sie 2020 16:11:13";" Zamknięcie Transakcji";"O4-83-42GTEZ";"T4-83-38QZWN";"O4-83-42GGT5";"Złoto - Kasowy";"2,08 Jednost.";"1 935,48";"-";"-";"-";"-";"3,71817";"14 968,60";"-17,56";"376,87";"-";"-";"-";"-";"-";"-";"-";"-";"-";"-";"-";"-";"-";"-";"-";"-";"-";"-";"-";"-";"-";"-";"-";"-";"-"
"20 Sie 2020 15:12:21";"Transakcja Sprzedaży";"O4-83-42GGT5";"T4-83-38QNS0";"-";"Złoto - Kasowy";"2,08 Jednost.";"1 933,21";"-";"1 952,56";"-";"-";"3,73026";"14 999,66";"0,00";"-";"-";"-";"-";"-";"-";"-";"-";"-";"-";"-";"-";"-";"-";"-";"-";"-";"-";"-";"-";"-";"-";"-";"-";"-";"-"
"20 Sie 2020 15:12:12";" Zamknięcie Transakcji";"O4-83-42GGS4";"T4-83-38QNQZ";"O4-83-42FSE7";"Złoto - Kasowy";"0,416 Jednost.";"1 932,99";"-";"-";"-";"-";"3,7079";"2 999,55";"7,47";"394,43";"-";"-";"-";"-";"-";"-";"-";"-";"-";"-";"-";"-";"-";"-";"-";"-";"-";"-";"-";"-";"-";"-";"-";"-";"-"
"20 Sie 2020 15:12:12";" Zamknięcie Transakcji";"O4-83-42GGS4";"T4-83-38QNQY";"O4-83-42FS5Y";"Złoto - Kasowy";"0,416 Jednost.";"1 932,99";"-";"-";"-";"-";"3,7079";"2 999,55";"4,10";"386,96";"-";"-";"-";"-";"-";"-";"-";"-";"-";"-";"-";"-";"-";"-";"-";"-";"-";"-";"-";"-";"-";"-";"-";"-";"-"
"20 Sie 2020 15:12:12";" Zamknięcie Transakcji";"O4-83-42GGS4";"T4-83-38QNQX";"O4-83-42FS18";"Złoto - Kasowy";"0,416 Jednost.";"1 932,99";"-";"-";"-";"-";"3,7079";"2 999,55";"7,82";"382,86";"-";"-";"-";"-";"-";"-";"-";"-";"-";"-";"-";"-";"-";"-";"-";"-";"-";"-";"-";"-";"-";"-";"-";"-";"-"
"20 Sie 2020 15:12:12";" Zamknięcie Transakcji";"O4-83-42GGS4";"T4-83-38QNQW";"O4-83-42FK2D";"Złoto - Kasowy";"0,4 Jednost.";"1 932,99";"-";"-";"-";"-";"3,73022";"2 884,19";"-19,07";"375,04";"-";"-";"-";"-";"-";"-";"-";"-";"-";"-";"-";"-";"-";"-";"-";"-";"-";"-";"-";"-";"-";"-";"-";"-";"-"
"20 Sie 2020 10:25:30";" Transakcja Kupna";"O4-83-42FSE7";"T4-83-38Q3MQ";"-";"Złoto - Kasowy";"0,416 Jednost.";"1 928,15";"-";"1 908,85";"-";"-";"3,73057";"2 992,32";"0,00";"-";"-";"-";"-";"-";"-";"-";"-";"-";"-";"-";"-";"-";"-";"-";"-";"-";"-";"-";"-";"-";"-";"-";"-";"-";"-"
"20 Sie 2020 10:24:24";" Transakcja Kupna";"O4-83-42FS5Y";"T4-83-38Q3CP";"-";"Złoto - Kasowy";"0,416 Jednost.";"1 930,33";"-";"1 911,02";"-";"-";"3,72966";"2 994,98";"0,00";"-";"-";"-";"-";"-";"-";"-";"-";"-";"-";"-";"-";"-";"-";"-";"-";"-";"-";"-";"-";"-";"-";"-";"-";"-";"-"
"20 Sie 2020 10:22:55";" Transakcja Kupna";"O4-83-42FS18";"T4-83-38Q37Y";"-";"Złoto - Kasowy";"0,416 Jednost.";"1 927,92";"-";"1 908,64";"-";"-";"3,73166";"2 992,84";"0,00";"-";"-";"-";"-";"-";"-";"-";"-";"-";"-";"-";"-";"-";"-";"-";"-";"-";"-";"-";"-";"-";"-";"-";"-";"-";"-"
"20 Sie 2020 10:22:19";"Stop Loss";"O4-83-42FQXG";"T4-83-38Q35R";"-";"Złoto - Kasowy";"0,416 Jednost.";"1 927,75";"-";"-";"-";"-";"3,73347";"2 994,03";"-2,00";"394,11";"-";"-";"-";"-";"-";"-";"-";"-";"-";"-";"-";"-";"-";"-";"-";"-";"-";"-";"-";"-";"-";"-";"-";"-";"-"
"20 Sie 2020 10:18:13";"Zmodyfikowano Stop Loss";"O4-83-42FQXG";"-";"O4-83-42FQXH";"Złoto - Kasowy";"0,416 Jednost.";"1 929,04";"-";"1 927,75";"-";"-";"-";"-";"-";"-";"-";"-";"-";"-";"-";"-";"-";"-";"-";"-";"-";"-";"-";"-";"-";"-";"-";"-";"-";"-";"-";"-";"-";"-";"-"
"20 Sie 2020 10:18:03";" Zamknięcie Transakcji";"O4-83-42FRC8";"T4-83-38Q2M9";"O4-83-42FNR9";"Złoto - Kasowy";"0,416 Jednost.";"1 931,66";"-";"-";"-";"-";"3,72549";"2 993,69";"-4,45";"396,11";"-";"-";"-";"-";"-";"-";"-";"-";"-";"-";"-";"-";"-";"-";"-";"-";"-";"-";"-";"-";"-";"-";"-";"-";"-"
"20 Sie 2020 10:15:22";" Transakcja Kupna";"O4-83-42FQXG";"T4-83-38Q278";"-";"Złoto - Kasowy";"0,416 Jednost.";"1 929,04";"-";"1 909,63";"-";"-";"3,72668";"2 990,58";"0,00";"-";"-";"-";"-";"-";"-";"-";"-";"-";"-";"-";"-";"-";"-";"-";"-";"-";"-";"-";"-";"-";"-";"-";"-";"-";"-"
"20 Sie 2020 09:54:48";" Transakcja Kupna";"O4-83-42FNR9";"T4-83-38Q0E0";"-";"Złoto - Kasowy";"0,416 Jednost.";"1 934,53";"-";"1 915,18";"-";"-";"3,71898";"2 992,90";"0,00";"-";"-";"-";"-";"-";"-";"-";"-";"-";"-";"-";"-";"-";"-";"-";"-";"-";"-";"-";"-";"-";"-";"-";"-";"-";"-"
"20 Sie 2020 09:54:41";"Odrzucono Zlecenie: brak wystarczających środków";"O4-83-42FNQW";"-";"-";"Złoto - Kasowy";"3,411 Jednost.";"-";"-";"-";"-";"-";"-";"-";"-";"-";"-";"-";"-";"-";"-";"-";"-";"-";"-";"-";"-";"-";"-";"-";"-";"-";"-";"-";"-";"-";"-";"-";"-";"-";"-"
"20 Sie 2020 09:39:18";"Transakcja Sprzedaży";"O4-83-42FLT5";"T4-83-38PYS3";"-";"Germany 30 - Kasowy";"0,0176 Jednost.";"12 875,13";"-";"13 004,64";"-";"-";"4,40378";"997,90";"0,00";"-";"-";"-";"-";"-";"-";"-";"-";"-";"-";"-";"-";"-";"-";"-";"-";"-";"-";"-";"-";"-";"-";"-";"-";"-";"-"
"20 Sie 2020 09:32:12";"Transakcja Sprzedaży";"O4-83-42FL07";"T4-83-38PY2J";"-";"Germany 30 - Kasowy";"0,0177 Jednost.";"12 844,84";"-";"14 114,48";"-";"-";"4,40362";"1 001,17";"0,00";"-";"-";"-";"-";"-";"-";"-";"-";"-";"-";"-";"-";"-";"-";"-";"-";"-";"-";"-";"-";"-";"-";"-";"-";"-";"-"
"20 Sie 2020 09:24:28";" Transakcja Kupna";"O4-83-42FK6L";"T4-83-38PXH9";"-";"EUR/USD";"400,00";"1,18645";"-";"1,11916";"-";"-";"4,40752";"1 763,00";"0,00";"-";"-";"-";"-";"-";"-";"-";"-";"-";"-";"-";"-";"-";"-";"-";"-";"-";"-";"-";"-";"-";"-";"-";"-";"-";"-"
"20 Sie 2020 09:23:56";" Transakcja Kupna";"O4-83-42FK3P";"T4-83-38PXCE";"-";"Gaz Ziemny - Kasowy";"150 Jednost.";"2,414";"-";"2,237";"-";"-";"3,71525";"1 345,29";"0,00";"-";"-";"-";"-";"-";"-";"-";"-";"-";"-";"-";"-";"-";"-";"-";"-";"-";"-";"-";"-";"-";"-";"-";"-";"-";"-"
"20 Sie 2020 09:23:43";" Transakcja Kupna";"O4-83-42FK2D";"T4-83-38PXBQ";"-";"Złoto - Kasowy";"0,4 Jednost.";"1 945,77";"-";"1 779,94";"-";"-";"3,71685";"2 892,85";"0,00";"-";"-";"-";"-";"-";"-";"-";"-";"-";"-";"-";"-";"-";"-";"-";"-";"-";"-";"-";"-";"-";"-";"-";"-";"-";"-"
"20 Sie 2020 09:23:19";"Transakcja Sprzedaży";"O4-83-42FK0D";"T4-83-38PX9P";"-";"Germany 30 - Kasowy";"0,0177 Jednost.";"12 827,42";"-";"14 096,04";"-";"-";"4,40888";"1 001,01";"0,00";"-";"-";"-";"-";"-";"-";"-";"-";"-";"-";"-";"-";"-";"-";"-";"-";"-";"-";"-";"-";"-";"-";"-";"-";"-";"-"
"19 Sie 2020 16:57:21";" Zamknięcie Transakcji";"O4-83-42DV4T";"T4-83-38NFVW";"O4-83-42DT1V";"Złoto - Kasowy";"3,411 Jednost.";"1 967,85";"-";"-";"-";"-";"3,69363";"24 942,03";"68,92";"400,56";"-";"-";"-";"-";"-";"-";"-";"-";"-";"-";"-";"-";"-";"-";"-";"-";"-";"-";"-";"-";"-";"-";"-";"-";"-"
"19 Sie 2020 16:47:48";"Transakcja Sprzedaży";"O4-83-42DT1V";"T4-83-38NEZ2";"-";"Złoto - Kasowy";"3,411 Jednost.";"1 973,32";"-";"1 993,06";"-";"-";"3,71376";"24 997,29";"0,00";"-";"-";"-";"-";"-";"-";"-";"-";"-";"-";"-";"-";"-";"-";"-";"-";"-";"-";"-";"-";"-";"-";"-";"-";"-";"-"
"19 Sie 2020 16:47:42";"Odrzucono Zlecenie: brak wystarczających środków";"O4-83-42DT1G";"-";"-";"Złoto - Kasowy";"6,823 Jednost.";"-";"-";"-";"-";"-";"-";"-";"-";"-";"-";"-";"-";"-";"-";"-";"-";"-";"-";"-";"-";"-";"-";"-";"-";"-";"-";"-";"-";"-";"-";"-";"-";"-";"-"
"19 Sie 2020 16:47:32";" Zamknięcie Transakcji";"O4-83-42DT10";"T4-83-38NEYK";"O4-83-42D9X4";"Złoto - Kasowy";"0,4 Jednost.";"1 972,41";"-";"-";"-";"-";"3,71276";"2 929,23";"-23,97";"331,64";"-";"-";"-";"-";"-";"-";"-";"-";"-";"-";"-";"-";"-";"-";"-";"-";"-";"-";"-";"-";"-";"-";"-";"-";"-"
"19 Sie 2020 16:47:32";" Zamknięcie Transakcji";"O4-83-42DT10";"T4-83-38NEYJ";"O4-83-42D9S1";"Złoto - Kasowy";"0,4 Jednost.";"1 972,41";"-";"-";"-";"-";"3,71276";"2 929,23";"-22,43";"355,61";"-";"-";"-";"-";"-";"-";"-";"-";"-";"-";"-";"-";"-";"-";"-";"-";"-";"-";"-";"-";"-";"-";"-";"-";"-"
"19 Sie 2020 16:47:32";" Zamknięcie Transakcji";"O4-83-42DT10";"T4-83-38NEYH";"O4-83-42D9QV";"Złoto - Kasowy";"0,4 Jednost.";"1 972,41";"-";"-";"-";"-";"3,71276";"2 929,23";"-22,99";"378,04";"-";"-";"-";"-";"-";"-";"-";"-";"-";"-";"-";"-";"-";"-";"-";"-";"-";"-";"-";"-";"-";"-";"-";"-";"-"
"19 Sie 2020 16:47:32";" Zamknięcie Transakcji";"O4-83-42DT10";"T4-83-38NEYG";"O4-83-42D9L0";"Złoto - Kasowy";"0,4 Jednost.";"1 972,41";"-";"-";"-";"-";"3,71276";"2 929,23";"-16,96";"401,03";"-";"-";"-";"-";"-";"-";"-";"-";"-";"-";"-";"-";"-";"-";"-";"-";"-";"-";"-";"-";"-";"-";"-";"-";"-"
"19 Sie 2020 16:47:32";" Zamknięcie Transakcji";"O4-83-42DT10";"T4-83-38NEYF";"O4-83-426DDB";"Złoto - Kasowy";"0,409 Jednost.";"1 972,41";"-";"-";"-";"-";"3,69056";"2 995,14";"35,64";"417,99";"-";"-";"-";"-";"-";"-";"-";"-";"-";"-";"-";"-";"-";"-";"-";"-";"-";"-";"-";"-";"-";"-";"-";"-";"-"
"19 Sie 2020 16:46:52";" Zamknięcie Transakcji";"O4-83-42DSY4";"T4-83-38NEWH";"O4-83-42CRQ2";"TRY/USD";"2 000,00";"0,13824";"-";"-";"-";"-";"3,69114";"1 027,44";"18,01";"382,35";"-";"-";"-";"-";"-";"-";"-";"-";"-";"-";"-";"-";"-";"-";"-";"-";"-";"-";"-";"-";"-";"-";"-";"-";"-"
"19 Sie 2020 16:46:49";" Zamknięcie Transakcji";"O4-83-42DSXP";"T4-83-38NEW7";"O4-83-42D53B";"Germany 30 - Kasowy";"0,0552 Jednost.";"12 958,64";"-";"-";"-";"-";"4,39318";"3 161,42";"12,61";"364,34";"-";"-";"-";"-";"-";"-";"-";"-";"-";"-";"-";"-";"-";"-";"-";"-";"-";"-";"-";"-";"-";"-";"-";"-";"-"
"19 Sie 2020 16:46:49";" Zamknięcie Transakcji";"O4-83-42DSXP";"T4-83-38NEW6";"O4-83-428SYG";"Germany 30 - Kasowy";"0,0552 Jednost.";"12 958,64";"-";"-";"-";"-";"4,39318";"3 161,42";"24,94";"351,73";"-";"-";"-";"-";"-";"-";"-";"-";"-";"-";"-";"-";"-";"-";"-";"-";"-";"-";"-";"-";"-";"-";"-";"-";"-"
"19 Sie 2020 16:46:49";" Zamknięcie Transakcji";"O4-83-42DSXP";"T4-83-38NEW5";"O4-83-426DG4";"Germany 30 - Kasowy";"0,0352 Jednost.";"12 958,64";"-";"-";"-";"-";"4,39318";"2 015,98";"13,25";"326,79";"-";"-";"-";"-";"-";"-";"-";"-";"-";"-";"-";"-";"-";"-";"-";"-";"-";"-";"-";"-";"-";"-";"-";"-";"-"
"19 Sie 2020 16:46:46";" Zamknięcie Transakcji";"O4-83-42DSXG";"T4-83-38NEVZ";"O4-83-426DH3";"Gaz Ziemny - Kasowy";"150 Jednost.";"2,393";"-";"-";"-";"-";"3,69311";"1 333,61";"17,17";"313,54";"-";"-";"-";"-";"-";"-";"-";"-";"-";"-";"-";"-";"-";"-";"-";"-";"-";"-";"-";"-";"-";"-";"-";"-";"-"
"19 Sie 2020 15:57:04";"Zmodyfikowano Stop Loss";"O4-83-42D9L0";"-";"O4-83-42D9L1";"Złoto - Kasowy";"0,4 Jednost.";"1 983,83";"-";"1 916,83";"-";"-";"-";"-";"-";"-";"-";"-";"-";"-";"-";"-";"-";"-";"-";"-";"-";"-";"-";"-";"-";"-";"-";"-";"-";"-";"-";"-";"-";"-";"-"
"19 Sie 2020 15:56:56";"Zmodyfikowano Stop Loss";"O4-83-42D9QV";"-";"O4-83-42D9QW";"Złoto - Kasowy";"0,4 Jednost.";"1 987,89";"-";"1 920,89";"-";"-";"-";"-";"-";"-";"-";"-";"-";"-";"-";"-";"-";"-";"-";"-";"-";"-";"-";"-";"-";"-";"-";"-";"-";"-";"-";"-";"-";"-";"-"
"19 Sie 2020 15:56:48";"Zmodyfikowano Stop Loss";"O4-83-42D9S1";"-";"O4-83-42D9S2";"Złoto - Kasowy";"0,4 Jednost.";"1 987,51";"-";"1 920,51";"-";"-";"-";"-";"-";"-";"-";"-";"-";"-";"-";"-";"-";"-";"-";"-";"-";"-";"-";"-";"-";"-";"-";"-";"-";"-";"-";"-";"-";"-";"-"
"19 Sie 2020 15:56:39";"Zmodyfikowano Stop Loss";"O4-83-42D9X4";"-";"O4-83-42D9X5";"Złoto - Kasowy";"0,4 Jednost.";"1 988,55";"-";"1 921,56";"-";"-";"-";"-";"-";"-";"-";"-";"-";"-";"-";"-";"-";"-";"-";"-";"-";"-";"-";"-";"-";"-";"-";"-";"-";"-";"-";"-";"-";"-";"-"
"19 Sie 2020 14:05:16";" Transakcja Kupna";"O4-83-42D9X4";"T4-83-38MZYQ";"-";"Złoto - Kasowy";"0,4 Jednost.";"1 988,55";"-";"1 968,66";"-";"-";"3,69349";"2 937,87";"0,00";"-";"-";"-";"-";"-";"-";"-";"-";"-";"-";"-";"-";"-";"-";"-";"-";"-";"-";"-";"-";"-";"-";"-";"-";"-";"-"
"19 Sie 2020 14:03:20";" Transakcja Kupna";"O4-83-42D9S1";"T4-83-38MZVC";"-";"Złoto - Kasowy";"0,4 Jednost.";"1 987,51";"-";"1 967,63";"-";"-";"3,69395";"2 936,70";"0,00";"-";"-";"-";"-";"-";"-";"-";"-";"-";"-";"-";"-";"-";"-";"-";"-";"-";"-";"-";"-";"-";"-";"-";"-";"-";"-"
"19 Sie 2020 14:02:57";" Transakcja Kupna";"O4-83-42D9QV";"T4-83-38MZTE";"-";"Złoto - Kasowy";"0,4 Jednost.";"1 987,89";"-";"1 968,01";"-";"-";"3,6941";"2 937,38";"0,00";"-";"-";"-";"-";"-";"-";"-";"-";"-";"-";"-";"-";"-";"-";"-";"-";"-";"-";"-";"-";"-";"-";"-";"-";"-";"-"
"19 Sie 2020 14:01:07";" Transakcja Kupna";"O4-83-42D9L0";"T4-83-38MZNE";"-";"Złoto - Kasowy";"0,4 Jednost.";"1 983,83";"-";"1 963,93";"-";"-";"3,69621";"2 933,06";"0,00";"-";"-";"-";"-";"-";"-";"-";"-";"-";"-";"-";"-";"-";"-";"-";"-";"-";"-";"-";"-";"-";"-";"-";"-";"-";"-"
"19 Sie 2020 14:00:51";" Zamknięcie Transakcji";"O4-83-42D9KF";"T4-83-38MZMY";"O4-83-42D9K1";"Złoto - Kasowy";"0,4 Jednost.";"1 983,87";"-";"-";"-";"-";"3,69615";"2 933,07";"-1,37";"296,37";"-";"-";"-";"-";"-";"-";"-";"-";"-";"-";"-";"-";"-";"-";"-";"-";"-";"-";"-";"-";"-";"-";"-";"-";"-"
"19 Sie 2020 14:00:44";" Transakcja Kupna";"O4-83-42D9K1";"T4-83-38MZMH";"-";"Złoto - Kasowy";"0,4 Jednost.";"1 984,8";"-";"1 964,95";"-";"-";"3,6954";"2 933,85";"0,00";"-";"-";"-";"-";"-";"-";"-";"-";"-";"-";"-";"-";"-";"-";"-";"-";"-";"-";"-";"-";"-";"-";"-";"-";"-";"-"
"19 Sie 2020 13:56:19";" Zamknięcie Transakcji";"O4-83-42D9DZ";"T4-83-38MZGQ";"O4-83-42D7FF";"Złoto - Kasowy";"0,4 Jednost.";"1 985,73";"-";"-";"-";"-";"3,69366";"2 933,84";"-2,79";"297,74";"-";"-";"-";"-";"-";"-";"-";"-";"-";"-";"-";"-";"-";"-";"-";"-";"-";"-";"-";"-";"-";"-";"-";"-";"-"
"19 Sie 2020 13:55:09";" Zamknięcie Transakcji";"O4-83-42D9BW";"T4-83-38MZF2";"O4-83-42D7H7";"Złoto - Kasowy";"0,4 Jednost.";"1 984,69";"-";"-";"-";"-";"3,6953";"2 933,60";"-1,27";"300,53";"-";"-";"-";"-";"-";"-";"-";"-";"-";"-";"-";"-";"-";"-";"-";"-";"-";"-";"-";"-";"-";"-";"-";"-";"-"
"19 Sie 2020 13:55:02";" Zamknięcie Transakcji";"O4-83-42D9BT";"T4-83-38MZF0";"O4-83-42D93Z";"Złoto - Kasowy";"0,4 Jednost.";"1 984,69";"-";"-";"-";"-";"3,6732";"2 933,60";"1,63";"301,80";"-";"-";"-";"-";"-";"-";"-";"-";"-";"-";"-";"-";"-";"-";"-";"-";"-";"-";"-";"-";"-";"-";"-";"-";"-"
"19 Sie 2020 13:50:24";" Transakcja Kupna";"O4-83-42D93Z";"T4-83-38MZ9Y";"-";"Złoto - Kasowy";"0,4 Jednost.";"1 983,58";"-";"1 963,73";"-";"-";"3,69542";"2 932,06";"0,00";"-";"-";"-";"-";"-";"-";"-";"-";"-";"-";"-";"-";"-";"-";"-";"-";"-";"-";"-";"-";"-";"-";"-";"-";"-";"-"
"19 Sie 2020 13:47:13";" Zamknięcie Transakcji";"O4-83-42D8YL";"T4-83-38MZ4W";"O4-83-42D8V3";"Złoto - Kasowy";"0,4 Jednost.";"1 982,72";"-";"-";"-";"-";"3,67353";"2 930,95";"0,18";"300,17";"-";"-";"-";"-";"-";"-";"-";"-";"-";"-";"-";"-";"-";"-";"-";"-";"-";"-";"-";"-";"-";"-";"-";"-";"-"
"19 Sie 2020 13:45:25";" Transakcja Kupna";"O4-83-42D8V3";"T4-83-38MZ2E";"-";"Złoto - Kasowy";"0,4 Jednost.";"1 982,6";"-";"1 962,77";"-";"-";"3,69656";"2 931,51";"0,00";"-";"-";"-";"-";"-";"-";"-";"-";"-";"-";"-";"-";"-";"-";"-";"-";"-";"-";"-";"-";"-";"-";"-";"-";"-";"-"
"19 Sie 2020 13:21:24";" Transakcja Kupna";"O4-83-42D7H7";"T4-83-38MY07";"-";"Złoto - Kasowy";"0,4 Jednost.";"1 985,55";"-";"1 965,69";"-";"-";"3,6942";"2 934,00";"0,00";"-";"-";"-";"-";"-";"-";"-";"-";"-";"-";"-";"-";"-";"-";"-";"-";"-";"-";"-";"-";"-";"-";"-";"-";"-";"-"
"19 Sie 2020 13:20:21";" Transakcja Kupna";"O4-83-42D7FF";"T4-83-38MXYK";"-";"Złoto - Kasowy";"0,4 Jednost.";"1 987,62";"-";"1 967,65";"-";"-";"3,6939";"2 936,82";"0,00";"-";"-";"-";"-";"-";"-";"-";"-";"-";"-";"-";"-";"-";"-";"-";"-";"-";"-";"-";"-";"-";"-";"-";"-";"-";"-"
"19 Sie 2020 12:30:25";" Transakcja Kupna";"O4-83-42D53B";"T4-83-38MW5E";"-";"Germany 30 - Kasowy";"0,0552 Jednost.";"12 906,64";"-";"12 777,57";"-";"-";"4,41399";"3 144,73";"0,00";"-";"-";"-";"-";"-";"-";"-";"-";"-";"-";"-";"-";"-";"-";"-";"-";"-";"-";"-";"-";"-";"-";"-";"-";"-";"-"
"19 Sie 2020 11:51:19";" Zamknięcie Transakcji";"O4-83-42D34C";"T4-83-38MTPW";"O4-83-42CNH7";"Złoto - Kasowy";"0,4 Jednost.";"1 986,3";"-";"-";"-";"-";"3,66856";"2 932,28";"3,60";"299,99";"-";"-";"-";"-";"-";"-";"-";"-";"-";"-";"-";"-";"-";"-";"-";"-";"-";"-";"-";"-";"-";"-";"-";"-";"-"
"19 Sie 2020 11:51:13";" Zamknięcie Transakcji";"O4-83-42D344";"T4-83-38MTPM";"O4-83-42CV8P";"Złoto - Kasowy";"0,4 Jednost.";"1 986,02";"-";"-";"-";"-";"3,69064";"2 931,87";"-0,84";"296,39";"-";"-";"-";"-";"-";"-";"-";"-";"-";"-";"-";"-";"-";"-";"-";"-";"-";"-";"-";"-";"-";"-";"-";"-";"-"
"19 Sie 2020 10:05:23";" Transakcja Kupna";"O4-83-42CV8P";"T4-83-38MMYV";"-";"Złoto - Kasowy";"0,4 Jednost.";"1 986,59";"-";"1 966,67";"-";"-";"3,67929";"2 923,69";"0,00";"-";"-";"-";"-";"-";"-";"-";"-";"-";"-";"-";"-";"-";"-";"-";"-";"-";"-";"-";"-";"-";"-";"-";"-";"-";"-"
"19 Sie 2020 09:39:18";" Transakcja Kupna";"O4-83-42CRQ2";"T4-83-38MKVD";"-";"TRY/USD";"2 000,00";"0,1358";"-";"0,12221";"-";"-";"0,49942";"998,84";"0,00";"-";"-";"-";"-";"-";"-";"-";"-";"-";"-";"-";"-";"-";"-";"-";"-";"-";"-";"-";"-";"-";"-";"-";"-";"-";"-"
"19 Sie 2020 09:17:37";" Transakcja Kupna";"O4-83-42CNH7";"T4-83-38MH63";"-";"Złoto - Kasowy";"0,4 Jednost.";"1 983,85";"-";"1 964,02";"-";"-";"3,6813";"2 921,25";"0,00";"-";"-";"-";"-";"-";"-";"-";"-";"-";"-";"-";"-";"-";"-";"-";"-";"-";"-";"-";"-";"-";"-";"-";"-";"-";"-"
"19 Sie 2020 09:06:38";"Stop Loss";"O4-83-42B81E";"T4-83-38MFVS";"-";"Złoto - Kasowy";"0,4 Jednost.";"1 982,95";"-";"-";"-";"-";"3,67714";"2 916,63";"-1,00";"297,23";"-";"-";"-";"-";"-";"-";"-";"-";"-";"-";"-";"-";"-";"-";"-";"-";"-";"-";"-";"-";"-";"-";"-";"-";"-"
"18 Sie 2020 23:00:35";"Koszty Utrzymania Pozycji";"852023490";"-";"-";"Rachunek";"-";"-";"-";"-";"-";"-";"-";"-";"-1,98";"298,23";"-";"-";"-";"-";"-";"-";"-1,98";"-";"-";"-";"-";"-";"-";"-";"-";"-";"-";"-";"-";"-";"-";"-";"-";"-";"-"
"18 Sie 2020 23:00:35";"Koszty Utrzymania Pozycji";"O4-83-428SYG";"-";"-";"Germany 30 - Kasowy";"-";"-";"-";"-";"-";"-";"-";"-";"-";"-";"-";"-";"710,69";"-2,48299%";"-0,21";"0,00";"-0,21";"-";"-";"-";"-";"-";"-";"-";"-";"-";"-";"-";"-";"-";"-";"-";"-";"-";"-"
"18 Sie 2020 23:00:35";"Koszty Utrzymania Pozycji";"O4-83-42B81E";"-";"-";"Złoto - Kasowy";"-";"-";"-";"-";"-";"-";"-";"-";"-";"-";"-";"-";"800,82";"-1,98377%";"-0,16";"0,00";"-0,16";"-";"-";"-";"-";"-";"-";"-";"-";"-";"-";"-";"-";"-";"-";"-";"-";"-";"-"
"18 Sie 2020 23:00:35";"Koszty Utrzymania Pozycji";"O4-83-426DH3";"-";"-";"Gaz Ziemny - Kasowy";"-";"-";"-";"-";"-";"-";"-";"-";"-";"-";"-";"-";"358,80";"-36,23733%";"-1,31";"0,00";"-1,31";"-";"-";"-";"-";"-";"-";"-";"-";"-";"-";"-";"-";"-";"-";"-";"-";"-";"-"
"18 Sie 2020 23:00:35";"Koszty Utrzymania Pozycji";"O4-83-426DG4";"-";"-";"Germany 30 - Kasowy";"-";"-";"-";"-";"-";"-";"-";"-";"-";"-";"-";"-";"453,19";"-2,48299%";"-0,14";"0,00";"-0,14";"-";"-";"-";"-";"-";"-";"-";"-";"-";"-";"-";"-";"-";"-";"-";"-";"-";"-"
"18 Sie 2020 23:00:35";"Koszty Utrzymania Pozycji";"O4-83-426DDB";"-";"-";"Złoto - Kasowy";"-";"-";"-";"-";"-";"-";"-";"-";"-";"-";"-";"-";"818,84";"-1,98377%";"-0,16";"0,00";"-0,16";"-";"-";"-";"-";"-";"-";"-";"-";"-";"-";"-";"-";"-";"-";"-";"-";"-";"-"
"18 Sie 2020 22:05:34";"Zmodyfikowano Stop Loss";"O4-83-428SYG";"-";"O4-83-428SYH";"Germany 30 - Kasowy";"0,0552 Jednost.";"12 855,81";"-";"12 034,58";"-";"-";"-";"-";"-";"-";"-";"-";"-";"-";"-";"-";"-";"-";"-";"-";"-";"-";"-";"-";"-";"-";"-";"-";"-";"-";"-";"-";"-";"-";"-"
"18 Sie 2020 16:46:26";"Zmodyfikowano Stop Loss";"O4-83-42B81E";"-";"O4-83-42B81F";"Złoto - Kasowy";"0,4 Jednost.";"1 983,63";"-";"1 982,95";"-";"-";"-";"-";"-";"-";"-";"-";"-";"-";"-";"-";"-";"-";"-";"-";"-";"-";"-";"-";"-";"-";"-";"-";"-";"-";"-";"-";"-";"-";"-"
"18 Sie 2020 16:46:19";" Zamknięcie Transakcji";"O4-83-42BCCK";"T4-83-38LG4P";"O4-83-42B4SW";"Złoto - Kasowy";"0,4 Jednost.";"1 994,42";"-";"-";"-";"-";"3,66283";"2 939,67";"1,16";"300,21";"-";"-";"-";"-";"-";"-";"-";"-";"-";"-";"-";"-";"-";"-";"-";"-";"-";"-";"-";"-";"-";"-";"-";"-";"-"
"18 Sie 2020 16:29:01";" Transakcja Kupna";"O4-83-42B81E";"T4-83-38LDDK";"-";"Złoto - Kasowy";"0,4 Jednost.";"1 983,63";"-";"1 963,75";"-";"-";"3,69028";"2 928,06";"0,00";"-";"-";"-";"-";"-";"-";"-";"-";"-";"-";"-";"-";"-";"-";"-";"-";"-";"-";"-";"-";"-";"-";"-";"-";"-";"-"
"18 Sie 2020 16:28:52";"Zmodyfikowano Stop Loss";"O4-83-42B4SW";"-";"O4-83-42B4SX";"Złoto - Kasowy";"0,4 Jednost.";"1 993,63";"-";"1 958,78";"-";"-";"-";"-";"-";"-";"-";"-";"-";"-";"-";"-";"-";"-";"-";"-";"-";"-";"-";"-";"-";"-";"-";"-";"-";"-";"-";"-";"-";"-";"-"
"18 Sie 2020 16:13:13";" Transakcja Kupna";"O4-83-42B4SW";"T4-83-38L95F";"-";"Złoto - Kasowy";"0,4 Jednost.";"1 993,63";"-";"1 973,64";"-";"-";"3,68313";"2 937,11";"0,00";"-";"-";"-";"-";"-";"-";"-";"-";"-";"-";"-";"-";"-";"-";"-";"-";"-";"-";"-";"-";"-";"-";"-";"-";"-";"-"
"18 Sie 2020 09:11:31";" Transakcja Kupna";"O4-83-428SYG";"T4-83-38K4S3";"-";"Germany 30 - Kasowy";"0,0552 Jednost.";"12 855,81";"-";"12 728,35";"-";"-";"4,41264";"3 131,38";"0,00";"-";"-";"-";"-";"-";"-";"-";"-";"-";"-";"-";"-";"-";"-";"-";"-";"-";"-";"-";"-";"-";"-";"-";"-";"-";"-"
"17 Sie 2020 23:00:35";"Koszty Utrzymania Pozycji";"851598383";"-";"-";"Rachunek";"-";"-";"-";"-";"-";"-";"-";"-";"-1,58";"299,05";"-";"-";"-";"-";"-";"-";"-1,58";"-";"-";"-";"-";"-";"-";"-";"-";"-";"-";"-";"-";"-";"-";"-";"-";"-";"-"
"17 Sie 2020 23:00:35";"Koszty Utrzymania Pozycji";"O4-83-426DH3";"-";"-";"Gaz Ziemny - Kasowy";"-";"-";"-";"-";"-";"-";"-";"-";"-";"-";"-";"-";"347,85";"-36,23733%";"-1,28";"0,00";"-1,28";"-";"-";"-";"-";"-";"-";"-";"-";"-";"-";"-";"-";"-";"-";"-";"-";"-";"-"
"17 Sie 2020 23:00:35";"Koszty Utrzymania Pozycji";"O4-83-426DG4";"-";"-";"Germany 30 - Kasowy";"-";"-";"-";"-";"-";"-";"-";"-";"-";"-";"-";"-";"455,19";"-2,48099%";"-0,14";"0,00";"-0,14";"-";"-";"-";"-";"-";"-";"-";"-";"-";"-";"-";"-";"-";"-";"-";"-";"-";"-"
"17 Sie 2020 23:00:35";"Koszty Utrzymania Pozycji";"O4-83-426DDB";"-";"-";"Złoto - Kasowy";"-";"-";"-";"-";"-";"-";"-";"-";"-";"-";"-";"-";"811,99";"-1,98377%";"-0,16";"0,00";"-0,16";"-";"-";"-";"-";"-";"-";"-";"-";"-";"-";"-";"-";"-";"-";"-";"-";"-";"-"
"17 Sie 2020 08:10:24";" Transakcja Kupna";"O4-83-426DH3";"T4-83-38H71F";"-";"Gaz Ziemny - Kasowy";"150 Jednost.";"2,362";"-";"2,185";"-";"-";"3,71734";"1 317,05";"0,00";"-";"-";"-";"-";"-";"-";"-";"-";"-";"-";"-";"-";"-";"-";"-";"-";"-";"-";"-";"-";"-";"-";"-";"-";"-";"-"
"17 Sie 2020 08:09:49";" Transakcja Kupna";"O4-83-426DG4";"T4-83-38H70N";"-";"Germany 30 - Kasowy";"0,0352 Jednost.";"12 872,95";"-";"12 235,37";"-";"-";"4,41115";"1 998,81";"0,00";"-";"-";"-";"-";"-";"-";"-";"-";"-";"-";"-";"-";"-";"-";"-";"-";"-";"-";"-";"-";"-";"-";"-";"-";"-";"-"
"17 Sie 2020 08:08:54";"Zmodyfikowano Stop Loss";"O4-83-426DDB";"-";"O4-83-426DDC";"Złoto - Kasowy";"0,409 Jednost.";"1 948,8";"-";"1 883,70";"-";"-";"-";"-";"-";"-";"-";"-";"-";"-";"-";"-";"-";"-";"-";"-";"-";"-";"-";"-";"-";"-";"-";"-";"-";"-";"-";"-";"-";"-";"-"
"17 Sie 2020 08:08:31";" Transakcja Kupna";"O4-83-426DDB";"T4-83-38H6YG";"-";"Złoto - Kasowy";"0,409 Jednost.";"1 948,8";"-";"1 929,37";"-";"-";"3,71791";"2 963,39";"0,00";"-";"-";"-";"-";"-";"-";"-";"-";"-";"-";"-";"-";"-";"-";"-";"-";"-";"-";"-";"-";"-";"-";"-";"-";"-";"-"
"13 Sie 2020 18:57:33";" Zamknięcie Transakcji";"O4-83-422PMY";"T4-83-38E7QM";"O4-83-41YDZZ";"Złoto - Kasowy";"0,409 Jednost.";"1 955,07";"-";"-";"-";"-";"3,70971";"2 984,21";"51,98";"300,63";"-";"-";"-";"-";"-";"-";"-";"-";"-";"-";"-";"-";"-";"-";"-";"-";"-";"-";"-";"-";"-";"-";"-";"-";"-"
"13 Sie 2020 18:57:28";" Zamknięcie Transakcji";"O4-83-422PMQ";"T4-83-38E7QH";"O4-83-41YE2H";"TRY/USD";"2 000,00";"0,13606";"-";"-";"-";"-";"3,73203";"1 017,30";"-7,17";"248,65";"-";"-";"-";"-";"-";"-";"-";"-";"-";"-";"-";"-";"-";"-";"-";"-";"-";"-";"-";"-";"-";"-";"-";"-";"-"
"13 Sie 2020 18:57:25";" Zamknięcie Transakcji";"O4-83-422PMP";"T4-83-38E7QG";"O4-83-41ZKK3";"Gaz Ziemny - Kasowy";"150 Jednost.";"2,142";"-";"-";"-";"-";"3,70987";"1 199,15";"36,73";"255,82";"-";"-";"-";"-";"-";"-";"-";"-";"-";"-";"-";"-";"-";"-";"-";"-";"-";"-";"-";"-";"-";"-";"-";"-";"-"
"13 Sie 2020 18:57:22";" Zamknięcie Transakcji";"O4-83-422PMN";"T4-83-38E7QF";"O4-83-4222TT";"Germany 30 - Kasowy";"0,0552 Jednost.";"12 998,85";"-";"-";"-";"-";"4,38394";"3 164,57";"7,89";"219,09";"-";"-";"-";"-";"-";"-";"-";"-";"-";"-";"-";"-";"-";"-";"-";"-";"-";"-";"-";"-";"-";"-";"-";"-";"-"
"13 Sie 2020 18:57:22";" Zamknięcie Transakcji";"O4-83-422PMN";"T4-83-38E7QE";"O4-83-41YE0E";"Germany 30 - Kasowy";"0,0552 Jednost.";"12 998,85";"-";"-";"-";"-";"4,38394";"3 164,57";"18,41";"211,20";"-";"-";"-";"-";"-";"-";"-";"-";"-";"-";"-";"-";"-";"-";"-";"-";"-";"-";"-";"-";"-";"-";"-";"-";"-"
"13 Sie 2020 16:51:59";"Zmodyfikowano Stop Loss";"O4-83-4222TT";"-";"O4-83-4222TV";"Germany 30 - Kasowy";"0,0552 Jednost.";"12 966,26";"-";"12 966,26";"-";"-";"-";"-";"-";"-";"-";"-";"-";"-";"-";"-";"-";"-";"-";"-";"-";"-";"-";"-";"-";"-";"-";"-";"-";"-";"-";"-";"-";"-";"-"
"13 Sie 2020 15:31:50";" Transakcja Kupna";"O4-83-4222TT";"T4-83-38DQ49";"-";"Germany 30 - Kasowy";"0,0552 Jednost.";"12 966,26";"-";"12 836,59";"-";"-";"4,41174";"3 157,64";"0,00";"-";"-";"-";"-";"-";"-";"-";"-";"-";"-";"-";"-";"-";"-";"-";"-";"-";"-";"-";"-";"-";"-";"-";"-";"-";"-"
"12 Sie 2020 23:00:35";"Koszty Utrzymania Pozycji";"850381735";"-";"-";"Rachunek";"-";"-";"-";"-";"-";"-";"-";"-";"-1,39";"192,79";"-";"-";"-";"-";"-";"-";"-1,39";"-";"-";"-";"-";"-";"-";"-";"-";"-";"-";"-";"-";"-";"-";"-";"-";"-";"-"
"12 Sie 2020 23:00:35";"Koszty Utrzymania Pozycji";"O4-83-41ZKK3";"-";"-";"Gaz Ziemny - Kasowy";"-";"-";"-";"-";"-";"-";"-";"-";"-";"-";"-";"-";"318,45";"-36,23563%";"-1,18";"0,00";"-1,18";"-";"-";"-";"-";"-";"-";"-";"-";"-";"-";"-";"-";"-";"-";"-";"-";"-";"-"
"12 Sie 2020 23:00:35";"Koszty Utrzymania Pozycji";"O4-83-41YE0E";"-";"-";"Germany 30 - Kasowy";"-";"-";"-";"-";"-";"-";"-";"-";"-";"-";"-";"-";"721,11";"-2,48899%";"-0,22";"0,00";"-0,22";"-";"-";"-";"-";"-";"-";"-";"-";"-";"-";"-";"-";"-";"-";"-";"-";"-";"-"
"12 Sie 2020 23:00:35";"Koszty Utrzymania Pozycji";"O4-83-41YDZZ";"-";"-";"Złoto - Kasowy";"-";"-";"-";"-";"-";"-";"-";"-";"-";"-";"-";"-";"783,69";"-1,98377%";"-0,16";"0,00";"-0,16";"-";"-";"-";"-";"-";"-";"-";"-";"-";"-";"-";"-";"-";"-";"-";"-";"-";"-"
"12 Sie 2020 23:00:35";"Koszty Utrzymania Pozycji";"O4-83-41YE2H";"-";"-";"TRY/USD";"-";"-";"-";"-";"-";"-";"-";"-";"-";"-";"-";"-";"2 000,00";"5,96600%";"0,17";"0,00";"0,17";"-";"-";"-";"-";"-";"-";"-";"-";"-";"-";"-";"-";"-";"-";"-";"-";"-";"-"
"12 Sie 2020 16:03:10";"Zmodyfikowano Stop Loss";"O4-83-41ZKK3";"-";"O4-83-41ZKK4";"Gaz Ziemny - Kasowy";"150 Jednost.";"2,076";"-";"1,945";"-";"-";"-";"-";"-";"-";"-";"-";"-";"-";"-";"-";"-";"-";"-";"-";"-";"-";"-";"-";"-";"-";"-";"-";"-";"-";"-";"-";"-";"-";"-"
"12 Sie 2020 16:03:03";" Transakcja Kupna";"O4-83-41ZKK3";"T4-83-38BPZ7";"-";"Gaz Ziemny - Kasowy";"150 Jednost.";"2,076";"-";"2,055";"-";"-";"3,75225";"1 168,45";"0,00";"-";"-";"-";"-";"-";"-";"-";"-";"-";"-";"-";"-";"-";"-";"-";"-";"-";"-";"-";"-";"-";"-";"-";"-";"-";"-"
"12 Sie 2020 09:21:56";"Zmodyfikowano Stop Loss";"O4-83-41YE0E";"-";"O4-83-41YE0F";"Germany 30 - Kasowy";"0,0552 Jednost.";"12 922,76";"-";"12 517,14";"-";"-";"-";"-";"-";"-";"-";"-";"-";"-";"-";"-";"-";"-";"-";"-";"-";"-";"-";"-";"-";"-";"-";"-";"-";"-";"-";"-";"-";"-";"-"
"12 Sie 2020 09:21:44";"Zmodyfikowano Stop Loss";"O4-83-41YDZZ";"-";"O4-83-41YE00";"Złoto - Kasowy";"0,409 Jednost.";"1 920,81";"-";"1 856,59";"-";"-";"-";"-";"-";"-";"-";"-";"-";"-";"-";"-";"-";"-";"-";"-";"-";"-";"-";"-";"-";"-";"-";"-";"-";"-";"-";"-";"-";"-";"-"
"12 Sie 2020 09:21:25";"Odrzucono Zlecenie: brak wystarczających środków";"O4-83-41YE2Z";"-";"-";"Gaz Ziemny - Kasowy";"150 Jednost.";"-";"-";"-";"-";"-";"-";"-";"-";"-";"-";"-";"-";"-";"-";"-";"-";"-";"-";"-";"-";"-";"-";"-";"-";"-";"-";"-";"-";"-";"-";"-";"-";"-";"-"
"12 Sie 2020 09:21:16";" Transakcja Kupna";"O4-83-41YE2H";"T4-83-389SQE";"-";"TRY/USD";"2 000,00";"0,13702";"-";"0,12389";"-";"-";"0,51619";"1 032,38";"0,00";"-";"-";"-";"-";"-";"-";"-";"-";"-";"-";"-";"-";"-";"-";"-";"-";"-";"-";"-";"-";"-";"-";"-";"-";"-";"-"
"12 Sie 2020 09:20:59";" Transakcja Kupna";"O4-83-41YE0E";"T4-83-389SND";"-";"Germany 30 - Kasowy";"0,0552 Jednost.";"12 922,76";"-";"12 793,09";"-";"-";"4,42144";"3 153,97";"0,00";"-";"-";"-";"-";"-";"-";"-";"-";"-";"-";"-";"-";"-";"-";"-";"-";"-";"-";"-";"-";"-";"-";"-";"-";"-";"-"
"12 Sie 2020 09:20:52";" Transakcja Kupna";"O4-83-41YDZZ";"T4-83-389SN3";"-";"Złoto - Kasowy";"0,409 Jednost.";"1 920,81";"-";"1 901,61";"-";"-";"3,76862";"2 960,67";"0,00";"-";"-";"-";"-";"-";"-";"-";"-";"-";"-";"-";"-";"-";"-";"-";"-";"-";"-";"-";"-";"-";"-";"-";"-";"-";"-"
"11 Sie 2020 22:10:00";" Zamknięcie Transakcji";"O4-83-41XDY5";"T4-83-3890Z4";"O4-83-41VV5C";"Złoto - Kasowy";"0,409 Jednost.";"1 912,44";"-";"-";"-";"-";"3,76769";"2 947,04";"-53,35";"194,18";"-";"-";"-";"-";"-";"-";"-";"-";"-";"-";"-";"-";"-";"-";"-";"-";"-";"-";"-";"-";"-";"-";"-";"-";"-"
"11 Sie 2020 22:10:00";" Zamknięcie Transakcji";"O4-83-41XDY5";"T4-83-3890Z3";"O4-83-41VSBQ";"Złoto - Kasowy";"0,409 Jednost.";"1 912,44";"-";"-";"-";"-";"3,76769";"2 947,04";"-65,69";"247,53";"-";"-";"-";"-";"-";"-";"-";"-";"-";"-";"-";"-";"-";"-";"-";"-";"-";"-";"-";"-";"-";"-";"-";"-";"-"
"11 Sie 2020 22:09:52";" Zamknięcie Transakcji";"O4-83-41XDXV";"T4-83-3890YY";"O4-83-41RVCE";"TRY/USD";"2 000,00";"0,1387";"-";"-";"-";"-";"3,7453";"1 045,84";"14,31";"313,22";"-";"-";"-";"-";"-";"-";"-";"-";"-";"-";"-";"-";"-";"-";"-";"-";"-";"-";"-";"-";"-";"-";"-";"-";"-"
"11 Sie 2020 22:09:44";" Zamknięcie Transakcji";"O4-83-41XDXK";"T4-83-3890YQ";"O4-83-41RV9X";"Germany 30 - Kasowy";"0,0552 Jednost.";"12 840,51";"-";"-";"-";"-";"4,39487";"3 133,80";"35,14";"298,91";"-";"-";"-";"-";"-";"-";"-";"-";"-";"-";"-";"-";"-";"-";"-";"-";"-";"-";"-";"-";"-";"-";"-";"-";"-"
"11 Sie 2020 22:09:36";" Zamknięcie Transakcji";"O4-83-41XDXD";"T4-83-3890YK";"O4-83-41SQPV";"Gaz Ziemny - Kasowy";"150 Jednost.";"2,114";"-";"-";"-";"-";"3,7451";"1 194,71";"6,18";"263,77";"-";"-";"-";"-";"-";"-";"-";"-";"-";"-";"-";"-";"-";"-";"-";"-";"-";"-";"-";"-";"-";"-";"-";"-";"-"
"11 Sie 2020 22:09:36";" Zamknięcie Transakcji";"O4-83-41XDXD";"T4-83-3890YJ";"O4-83-41RVD7";"Gaz Ziemny - Kasowy";"150 Jednost.";"2,114";"-";"-";"-";"-";"3,76764";"1 194,71";"-31,08";"257,59";"-";"-";"-";"-";"-";"-";"-";"-";"-";"-";"-";"-";"-";"-";"-";"-";"-";"-";"-";"-";"-";"-";"-";"-";"-"
"11 Sie 2020 15:07:59";" Transakcja Kupna";"O4-83-41VV5C";"T4-83-387P6M";"-";"Złoto - Kasowy";"0,409 Jednost.";"1 947,06";"-";"1 752,36";"-";"-";"3,75001";"2 986,31";"0,00";"-";"-";"-";"-";"-";"-";"-";"-";"-";"-";"-";"-";"-";"-";"-";"-";"-";"-";"-";"-";"-";"-";"-";"-";"-";"-"
"11 Sie 2020 15:07:14";"Stop Loss";"O4-83-41TJNF";"T4-83-387P1D";"-";"Złoto - Kasowy";"0,409 Jednost.";"1 948,88";"-";"-";"-";"-";"3,74811";"2 987,58";"-89,65";"288,67";"-";"-";"-";"-";"-";"-";"-";"-";"-";"-";"-";"-";"-";"-";"-";"-";"-";"-";"-";"-";"-";"-";"-";"-";"-"
"11 Sie 2020 14:53:25";"Zmodyfikowano Stop Loss";"O4-83-41VSBQ";"-";"O4-83-41VSBR";"Złoto - Kasowy";"0,409 Jednost.";"1 955,07";"-";"1 896,31";"-";"-";"-";"-";"-";"-";"-";"-";"-";"-";"-";"-";"-";"-";"-";"-";"-";"-";"-";"-";"-";"-";"-";"-";"-";"-";"-";"-";"-";"-";"-"
"11 Sie 2020 14:53:10";" Transakcja Kupna";"O4-83-41VSBQ";"T4-83-387MP0";"-";"Złoto - Kasowy";"0,409 Jednost.";"1 955,07";"-";"1 935,52";"-";"-";"3,74447";"2 994,16";"0,00";"-";"-";"-";"-";"-";"-";"-";"-";"-";"-";"-";"-";"-";"-";"-";"-";"-";"-";"-";"-";"-";"-";"-";"-";"-";"-"
"11 Sie 2020 08:11:45";" Transakcja Kupna";"O4-83-41TJNF";"T4-83-386M11";"-";"Złoto - Kasowy";"0,409 Jednost.";"2 007,36";"-";"1 948,88";"-";"-";"3,75607";"3 083,77";"0,00";"-";"-";"-";"-";"-";"-";"-";"-";"-";"-";"-";"-";"-";"-";"-";"-";"-";"-";"-";"-";"-";"-";"-";"-";"-";"-"
"11 Sie 2020 07:30:31";"Stop Loss";"O4-83-41RVDW";"T4-83-386JSJ";"-";"Złoto - Kasowy";"0,409 Jednost.";"2 012,24";"-";"-";"-";"-";"3,75338";"3 089,05";"-31,21";"378,32";"-";"-";"-";"-";"-";"-";"-";"-";"-";"-";"-";"-";"-";"-";"-";"-";"-";"-";"-";"-";"-";"-";"-";"-";"-"
"10 Sie 2020 23:00:28";"Koszty Utrzymania Pozycji";"849372515";"-";"-";"Rachunek";"-";"-";"-";"-";"-";"-";"-";"-";"-2,55";"409,53";"-";"-";"-";"-";"-";"-";"-2,55";"-";"-";"-";"-";"-";"-";"-";"-";"-";"-";"-";"-";"-";"-";"-";"-";"-";"-"
"10 Sie 2020 23:00:28";"Koszty Utrzymania Pozycji";"O4-83-41RV9X";"-";"-";"Germany 30 - Kasowy";"-";"-";"-";"-";"-";"-";"-";"-";"-";"-";"-";"-";"703,32";"-2,48099%";"-0,21";"0,00";"-0,21";"-";"-";"-";"-";"-";"-";"-";"-";"-";"-";"-";"-";"-";"-";"-";"-";"-";"-"
"10 Sie 2020 23:00:28";"Koszty Utrzymania Pozycji";"O4-83-41RVD7";"-";"-";"Gaz Ziemny - Kasowy";"-";"-";"-";"-";"-";"-";"-";"-";"-";"-";"-";"-";"319,95";"-36,23733%";"-1,19";"0,00";"-1,19";"-";"-";"-";"-";"-";"-";"-";"-";"-";"-";"-";"-";"-";"-";"-";"-";"-";"-"
"10 Sie 2020 23:00:28";"Koszty Utrzymania Pozycji";"O4-83-41SQPV";"-";"-";"Gaz Ziemny - Kasowy";"-";"-";"-";"-";"-";"-";"-";"-";"-";"-";"-";"-";"319,95";"-36,23733%";"-1,19";"0,00";"-1,19";"-";"-";"-";"-";"-";"-";"-";"-";"-";"-";"-";"-";"-";"-";"-";"-";"-";"-"
"10 Sie 2020 23:00:28";"Koszty Utrzymania Pozycji";"O4-83-41RVCE";"-";"-";"TRY/USD";"-";"-";"-";"-";"-";"-";"-";"-";"-";"-";"-";"-";"2 000,00";"5,96600%";"0,17";"0,00";"0,17";"-";"-";"-";"-";"-";"-";"-";"-";"-";"-";"-";"-";"-";"-";"-";"-";"-";"-"
"10 Sie 2020 23:00:28";"Koszty Utrzymania Pozycji";"O4-83-41RVDW";"-";"-";"Złoto - Kasowy";"-";"-";"-";"-";"-";"-";"-";"-";"-";"-";"-";"-";"829,33";"-1,49503%";"-0,13";"0,00";"-0,13";"-";"-";"-";"-";"-";"-";"-";"-";"-";"-";"-";"-";"-";"-";"-";"-";"-";"-"
"10 Sie 2020 18:46:16";" Transakcja Kupna";"O4-83-41SQPV";"T4-83-385Z3C";"-";"Gaz Ziemny - Kasowy";"150 Jednost.";"2,103";"-";"2,082";"-";"-";"3,75372";"1 184,11";"0,00";"-";"-";"-";"-";"-";"-";"-";"-";"-";"-";"-";"-";"-";"-";"-";"-";"-";"-";"-";"-";"-";"-";"-";"-";"-";"-"
"10 Sie 2020 14:53:05";"Zmodyfikowano Stop Loss";"O4-83-41RV9X";"-";"O4-83-41RV9Y";"Germany 30 - Kasowy";"0,0552 Jednost.";"12 695,67";"-";"12 466,94";"-";"-";"-";"-";"-";"-";"-";"-";"-";"-";"-";"-";"-";"-";"-";"-";"-";"-";"-";"-";"-";"-";"-";"-";"-";"-";"-";"-";"-";"-";"-"
"10 Sie 2020 14:52:53";"Odrzucono Zlecenie: brak wystarczających środków";"O4-83-41RVEM";"-";"-";"Kawa Arabica - Kasowy";"500 Jednost.";"-";"-";"-";"-";"-";"-";"-";"-";"-";"-";"-";"-";"-";"-";"-";"-";"-";"-";"-";"-";"-";"-";"-";"-";"-";"-";"-";"-";"-";"-";"-";"-";"-";"-"
"10 Sie 2020 14:52:22";" Transakcja Kupna";"O4-83-41RVDW";"T4-83-38560S";"-";"Złoto - Kasowy";"0,409 Jednost.";"2 032,57";"-";"2 012,24";"-";"-";"3,75067";"3 118,01";"0,00";"-";"-";"-";"-";"-";"-";"-";"-";"-";"-";"-";"-";"-";"-";"-";"-";"-";"-";"-";"-";"-";"-";"-";"-";"-";"-"
"10 Sie 2020 14:52:11";"Zmodyfikowano Stop Loss";"O4-83-41RVD7";"-";"O4-83-41RVD8";"Gaz Ziemny - Kasowy";"150 Jednost.";"2,169";"-";"1,928";"-";"-";"-";"-";"-";"-";"-";"-";"-";"-";"-";"-";"-";"-";"-";"-";"-";"-";"-";"-";"-";"-";"-";"-";"-";"-";"-";"-";"-";"-";"-"
"10 Sie 2020 14:52:06";" Transakcja Kupna";"O4-83-41RVD7";"T4-83-385606";"-";"Gaz Ziemny - Kasowy";"150 Jednost.";"2,169";"-";"2,147";"-";"-";"3,75067";"1 220,28";"0,00";"-";"-";"-";"-";"-";"-";"-";"-";"-";"-";"-";"-";"-";"-";"-";"-";"-";"-";"-";"-";"-";"-";"-";"-";"-";"-"
"10 Sie 2020 14:51:53";"Zmodyfikowano Stop Loss";"O4-83-41RVCE";"-";"O4-83-41RVCF";"TRY/USD";"2 000,00";"0,13679";"-";"0,12597";"-";"-";"-";"-";"-";"-";"-";"-";"-";"-";"-";"-";"-";"-";"-";"-";"-";"-";"-";"-";"-";"-";"-";"-";"-";"-";"-";"-";"-";"-";"-"
"10 Sie 2020 14:51:44";" Transakcja Kupna";"O4-83-41RVCE";"T4-83-3855ZL";"-";"TRY/USD";"2 000,00";"0,13679";"-";"0,13550";"-";"-";"0,51303";"1 026,06";"0,00";"-";"-";"-";"-";"-";"-";"-";"-";"-";"-";"-";"-";"-";"-";"-";"-";"-";"-";"-";"-";"-";"-";"-";"-";"-";"-"
"10 Sie 2020 14:51:01";" Transakcja Kupna";"O4-83-41RV9X";"T4-83-3855YD";"-";"Germany 30 - Kasowy";"0,0552 Jednost.";"12 695,67";"-";"12 568,71";"-";"-";"4,41323";"3 092,79";"0,00";"-";"-";"-";"-";"-";"-";"-";"-";"-";"-";"-";"-";"-";"-";"-";"-";"-";"-";"-";"-";"-";"-";"-";"-";"-";"-"
"07 Sie 2020 18:33:12";" Zamknięcie Transakcji";"O4-82-41PZ56";"T4-82-383QQB";"O4-82-41NFXL";"EUR/USD";"1 000,00";"1,17748";"-";"-";"-";"-";"3,75887";"4 425,95";"-24,24";"412,08";"-";"-";"-";"-";"-";"-";"-";"-";"-";"-";"-";"-";"-";"-";"-";"-";"-";"-";"-";"-";"-";"-";"-";"-";"-"
"07 Sie 2020 18:33:08";" Zamknięcie Transakcji";"O4-82-41PZ55";"T4-82-383QQ9";"O4-82-41NTSK";"Germany 30 - Kasowy";"0,0552 Jednost.";"12 677,36";"-";"-";"-";"-";"4,39948";"3 097,23";"27,23";"436,32";"-";"-";"-";"-";"-";"-";"-";"-";"-";"-";"-";"-";"-";"-";"-";"-";"-";"-";"-";"-";"-";"-";"-";"-";"-"
"07 Sie 2020 18:33:08";" Zamknięcie Transakcji";"O4-82-41PZ55";"T4-82-383QQ8";"O4-82-41NRDW";"Germany 30 - Kasowy";"0,0552 Jednost.";"12 677,36";"-";"-";"-";"-";"4,39948";"3 097,23";"36,85";"409,09";"-";"-";"-";"-";"-";"-";"-";"-";"-";"-";"-";"-";"-";"-";"-";"-";"-";"-";"-";"-";"-";"-";"-";"-";"-"
"07 Sie 2020 18:33:08";" Zamknięcie Transakcji";"O4-82-41PZ55";"T4-82-383QQ7";"O4-82-41NFPX";"Germany 30 - Kasowy";"0,0552 Jednost.";"12 677,36";"-";"-";"-";"-";"4,39948";"3 097,23";"20,70";"372,24";"-";"-";"-";"-";"-";"-";"-";"-";"-";"-";"-";"-";"-";"-";"-";"-";"-";"-";"-";"-";"-";"-";"-";"-";"-"
"07 Sie 2020 18:33:04";" Zamknięcie Transakcji";"O4-82-41PZ53";"T4-82-383QQ6";"O4-82-41P523";"Srebro - Kasowy";"30 Jednost.";"27,866";"-";"-";"-";"-";"3,75887";"3 142,34";"-51,20";"351,54";"-";"-";"-";"-";"-";"-";"-";"-";"-";"-";"-";"-";"-";"-";"-";"-";"-";"-";"-";"-";"-";"-";"-";"-";"-"
"07 Sie 2020 18:33:01";" Zamknięcie Transakcji";"O4-82-41PZ50";"T4-82-383QQ3";"O4-82-41NYN3";"TRY/USD";"2 000,00";"0,13789";"-";"-";"-";"-";"3,75876";"1 037,32";"-16,84";"402,74";"-";"-";"-";"-";"-";"-";"-";"-";"-";"-";"-";"-";"-";"-";"-";"-";"-";"-";"-";"-";"-";"-";"-";"-";"-"
"07 Sie 2020 16:07:42";"Zmodyfikowano Stop Loss";"O4-82-41P523";"-";"O4-82-41P524";"Srebro - Kasowy";"30 Jednost.";"28,32";"-";"26,858";"-";"-";"-";"-";"-";"-";"-";"-";"-";"-";"-";"-";"-";"-";"-";"-";"-";"-";"-";"-";"-";"-";"-";"-";"-";"-";"-";"-";"-";"-";"-"
"07 Sie 2020 14:38:36";"Zmodyfikowano Stop Loss";"O4-82-41P523";"-";"O4-82-41P524";"Srebro - Kasowy";"30 Jednost.";"28,32";"-";"27,294";"-";"-";"-";"-";"-";"-";"-";"-";"-";"-";"-";"-";"-";"-";"-";"-";"-";"-";"-";"-";"-";"-";"-";"-";"-";"-";"-";"-";"-";"-";"-"
"07 Sie 2020 14:38:29";" Transakcja Kupna";"O4-82-41P523";"T4-82-383225";"-";"Srebro - Kasowy";"30 Jednost.";"28,32";"-";"28,032";"-";"-";"3,73871";"3 176,40";"0,00";"-";"-";"-";"-";"-";"-";"-";"-";"-";"-";"-";"-";"-";"-";"-";"-";"-";"-";"-";"-";"-";"-";"-";"-";"-";"-"
"07 Sie 2020 14:30:06";"Stop Loss";"O4-82-41NFR4";"T4-82-382YZS";"-";"Srebro - Kasowy";"30 Jednost.";"27,833";"-";"-";"-";"-";"3,73708";"3 120,42";"-33,52";"419,58";"-";"-";"-";"-";"-";"-";"-";"-";"-";"-";"-";"-";"-";"-";"-";"-";"-";"-";"-";"-";"-";"-";"-";"-";"-"
"07 Sie 2020 13:40:29";"Zmodyfikowano Stop Loss";"O4-82-41NYN3";"-";"O4-82-41NYN4";"TRY/USD";"2 000,00";"0,14013";"-";"0,13531";"-";"-";"-";"-";"-";"-";"-";"-";"-";"-";"-";"-";"-";"-";"-";"-";"-";"-";"-";"-";"-";"-";"-";"-";"-";"-";"-";"-";"-";"-";"-"
"07 Sie 2020 13:26:10";" Transakcja Kupna";"O4-82-41NYN3";"T4-82-382VWT";"-";"TRY/USD";"2 000,00";"0,14013";"-";"0,13875";"-";"-";"0,52359";"1 047,18";"0,00";"-";"-";"-";"-";"-";"-";"-";"-";"-";"-";"-";"-";"-";"-";"-";"-";"-";"-";"-";"-";"-";"-";"-";"-";"-";"-"
"07 Sie 2020 12:10:13";" Transakcja Kupna";"O4-82-41NTSK";"T4-82-382RVE";"-";"Germany 30 - Kasowy";"0,0552 Jednost.";"12 565,23";"-";"12 439,57";"-";"-";"4,4238";"3 068,35";"0,00";"-";"-";"-";"-";"-";"-";"-";"-";"-";"-";"-";"-";"-";"-";"-";"-";"-";"-";"-";"-";"-";"-";"-";"-";"-";"-"
"07 Sie 2020 11:30:20";"Zmodyfikowano Stop Loss";"O4-82-41NFPX";"-";"O4-82-41NFPY";"Germany 30 - Kasowy";"0,0552 Jednost.";"12 592,14";"-";"12 398,52";"-";"-";"-";"-";"-";"-";"-";"-";"-";"-";"-";"-";"-";"-";"-";"-";"-";"-";"-";"-";"-";"-";"-";"-";"-";"-";"-";"-";"-";"-";"-"
"07 Sie 2020 11:30:10";" Transakcja Kupna";"O4-82-41NRDW";"T4-82-382PYQ";"-";"Germany 30 - Kasowy";"0,0552 Jednost.";"12 525,63";"-";"12 400,62";"-";"-";"4,42708";"3 060,94";"0,00";"-";"-";"-";"-";"-";"-";"-";"-";"-";"-";"-";"-";"-";"-";"-";"-";"-";"-";"-";"-";"-";"-";"-";"-";"-";"-"
"07 Sie 2020 09:30:47";" Transakcja Kupna";"O4-82-41NFXL";"T4-82-382GGG";"-";"EUR/USD";"1 000,00";"1,18393";"-";"1,17209";"-";"-";"4,42729";"4 427,29";"0,00";"-";"-";"-";"-";"-";"-";"-";"-";"-";"-";"-";"-";"-";"-";"-";"-";"-";"-";"-";"-";"-";"-";"-";"-";"-";"-"
"07 Sie 2020 09:29:30";"Odrzucono Zlecenie: brak wystarczających środków";"O4-82-41NFRV";"-";"-";"Gaz Ziemny - Kasowy";"150 Jednost.";"-";"-";"-";"-";"-";"-";"-";"-";"-";"-";"-";"-";"-";"-";"-";"-";"-";"-";"-";"-";"-";"-";"-";"-";"-";"-";"-";"-";"-";"-";"-";"-";"-";"-"
"07 Sie 2020 09:29:12";" Transakcja Kupna";"O4-82-41NFR4";"T4-82-382GC6";"-";"Srebro - Kasowy";"30 Jednost.";"28,132";"-";"27,855";"-";"-";"3,74022";"3 156,59";"0,00";"-";"-";"-";"-";"-";"-";"-";"-";"-";"-";"-";"-";"-";"-";"-";"-";"-";"-";"-";"-";"-";"-";"-";"-";"-";"-"
"07 Sie 2020 09:28:47";" Transakcja Kupna";"O4-82-41NFPX";"T4-82-382GBB";"-";"Germany 30 - Kasowy";"0,0552 Jednost.";"12 592,14";"-";"12 466,22";"-";"-";"4,42827";"3 078,02";"0,00";"-";"-";"-";"-";"-";"-";"-";"-";"-";"-";"-";"-";"-";"-";"-";"-";"-";"-";"-";"-";"-";"-";"-";"-";"-";"-"
"06 Sie 2020 20:43:16";" Zamknięcie Transakcji";"O4-82-41METT";"T4-82-381NG5";"O4-82-41L5LH";"Złoto - Kasowy";"0,409 Jednost.";"2 060,2";"-";"-";"-";"-";"3,71027";"3 145,16";"5,57";"453,10";"-";"-";"-";"-";"-";"-";"-";"-";"-";"-";"-";"-";"-";"-";"-";"-";"-";"-";"-";"-";"-";"-";"-";"-";"-"
"06 Sie 2020 20:43:16";" Zamknięcie Transakcji";"O4-82-41METT";"T4-82-381NG4";"O4-82-41HYQ5";"Złoto - Kasowy";"0,409 Jednost.";"2 060,2";"-";"-";"-";"-";"3,73259";"3 145,16";"-9,97";"447,53";"-";"-";"-";"-";"-";"-";"-";"-";"-";"-";"-";"-";"-";"-";"-";"-";"-";"-";"-";"-";"-";"-";"-";"-";"-"
"06 Sie 2020 20:43:12";" Zamknięcie Transakcji";"O4-82-41METR";"T4-82-381NG2";"O4-82-41L12W";"TRY/USD";"2 000,00";"0,13816";"-";"-";"-";"-";"3,73259";"1 032,08";"-3,06";"457,50";"-";"-";"-";"-";"-";"-";"-";"-";"-";"-";"-";"-";"-";"-";"-";"-";"-";"-";"-";"-";"-";"-";"-";"-";"-"
"06 Sie 2020 20:43:07";" Zamknięcie Transakcji";"O4-82-41METK";"T4-82-381NFX";"O4-82-41KT65";"Germany 30 - Kasowy";"0,0552 Jednost.";"12 669,52";"-";"-";"-";"-";"4,43166";"3 099,31";"-9,80";"460,56";"-";"-";"-";"-";"-";"-";"-";"-";"-";"-";"-";"-";"-";"-";"-";"-";"-";"-";"-";"-";"-";"-";"-";"-";"-"
"06 Sie 2020 20:26:44";"Stop Loss";"O4-82-41KSVM";"T4-82-381M55";"-";"Gaz Ziemny - Kasowy";"150 Jednost.";"2,116";"-";"-";"-";"-";"3,73273";"1 184,76";"-31,91";"470,36";"-";"-";"-";"-";"-";"-";"-";"-";"-";"-";"-";"-";"-";"-";"-";"-";"-";"-";"-";"-";"-";"-";"-";"-";"-"
"06 Sie 2020 14:23:10";"Transakcja Sprzedaży";"O4-82-41L5LH";"T4-82-380KZR";"-";"Złoto - Kasowy";"0,409 Jednost.";"2 063,87";"-";"2 084,55";"-";"-";"3,72859";"3 147,38";"0,00";"-";"-";"-";"-";"-";"-";"-";"-";"-";"-";"-";"-";"-";"-";"-";"-";"-";"-";"-";"-";"-";"-";"-";"-";"-";"-"
"06 Sie 2020 13:39:50";"Zmodyfikowano Stop Loss";"O4-82-41L12W";"-";"O4-82-41L12X";"TRY/USD";"2 000,00";"0,13857";"-";"0,13207";"-";"-";"-";"-";"-";"-";"-";"-";"-";"-";"-";"-";"-";"-";"-";"-";"-";"-";"-";"-";"-";"-";"-";"-";"-";"-";"-";"-";"-";"-";"-"
"06 Sie 2020 13:39:41";" Transakcja Kupna";"O4-82-41L12W";"T4-82-380G86";"-";"TRY/USD";"2 000,00";"0,13857";"-";"0,13715";"-";"-";"0,51678";"1 033,56";"0,00";"-";"-";"-";"-";"-";"-";"-";"-";"-";"-";"-";"-";"-";"-";"-";"-";"-";"-";"-";"-";"-";"-";"-";"-";"-";"-"
"06 Sie 2020 13:30:34";"Zmodyfikowano Stop Loss";"O4-82-41HYQ5";"-";"O4-82-41HYQ6";"Złoto - Kasowy";"0,409 Jednost.";"2 053,67";"-";"2 119,18";"-";"-";"-";"-";"-";"-";"-";"-";"-";"-";"-";"-";"-";"-";"-";"-";"-";"-";"-";"-";"-";"-";"-";"-";"-";"-";"-";"-";"-";"-";"-"
"06 Sie 2020 12:30:00";"Transakcja Sprzedaży";"O4-82-41KT65";"T4-82-3809GJ";"-";"Germany 30 - Kasowy";"0,0552 Jednost.";"12 629,45";"-";"12 755,75";"-";"-";"4,42291";"3 083,41";"0,00";"-";"-";"-";"-";"-";"-";"-";"-";"-";"-";"-";"-";"-";"-";"-";"-";"-";"-";"-";"-";"-";"-";"-";"-";"-";"-"
"06 Sie 2020 12:25:18";"Zmodyfikowano Stop Loss";"O4-82-41KSVM";"-";"O4-82-41KSVN";"Gaz Ziemny - Kasowy";"150 Jednost.";"2,173";"-";"2,116";"-";"-";"-";"-";"-";"-";"-";"-";"-";"-";"-";"-";"-";"-";"-";"-";"-";"-";"-";"-";"-";"-";"-";"-";"-";"-";"-";"-";"-";"-";"-"
"06 Sie 2020 12:25:08";" Transakcja Kupna";"O4-82-41KSVM";"T4-82-38095P";"-";"Gaz Ziemny - Kasowy";"150 Jednost.";"2,173";"-";"2,151";"-";"-";"3,73116";"1 216,17";"0,00";"-";"-";"-";"-";"-";"-";"-";"-";"-";"-";"-";"-";"-";"-";"-";"-";"-";"-";"-";"-";"-";"-";"-";"-";"-";"-"